"B07001_049E","B07001_065E","B07001_081E","B08101_025E","B11007_001E","B11007_002E","B11007_004E","B11007_005E","B11007_006E","B11007_007E","B11007_009E","B11007_010E","B11007_011E","B11011_001E","B19013_001E","B19083_001E","B23020_001E","B25024_001E","B27020_001E","B27020_003E","B27020_009E","B27020_014E","NAME","state","county"
"1486","222","38","67","7737","2764","1727","1658","69","4973","3929","3639","290","7737","46650","0.4373","39.2","9315","19948","18129","94","81","Fayette County, Illinois","17","051"
"2171","331","10","52","10797","3496","1993","1910","83","7301","5473","4860","613","10797","57308","0.4201","38.3","12050","25735","24298","170","113","Logan County, Illinois","17","107"
"610","258","40","85","9972","3285","1723","1684","39","6687","5253","4970","283","9972","44090","0.4692","38.4","11712","23540","22336","158","53","Saline County, Illinois","17","165"
"17578","18881","3858","15805","246122","67788","43770","41834","1936","178334","147100","138234","8866","246122","89427","0.4847","39.2","264078","685292","534535","61007","43446","Lake County, Illinois","17","097"
"95","358","23","17","5822","1958","1158","1125","33","3864","2943","2781","162","5822","47481","0.4097","38.6","7099","13979","13172","54","1","Massac County, Illinois","17","127"
"280","96","223","12","5043","1548","810","783","27","3495","2801","2553","248","5043","52373","0.4227","38.2","5822","12358","10567","354","762","Cass County, Illinois","17","017"
"1553","541","83","25","14742","4182","2457","2323","134","10560","8235","7584","651","14742","53632","0.3876","37.8","16049","35928","32638","187","286","Huntington County, Indiana","18","069"
"1104","626","49","25","9879","3315","2174","2053","121","6564","5150","4752","398","9879","54576","0.3940","40.5","13123","23866","21011","255","337","White County, Indiana","18","181"
"683","157","12","38","8174","2588","1466","1377","89","5586","4348","3977","371","8174","47658","0.4177","39.3","9253","20638","18514","181","116","Jay County, Indiana","18","075"
"1675","790","136","24","17823","5500","3031","2845","186","12323","10072","9100","972","17823","60404","0.4057","39.6","19329","43731","39971","232","529","Shelby County, Indiana","18","145"
"1272","315","39","0","7644","2505","1539","1441","98","5139","4110","3875","235","7644","50245","0.4296","39.3","8959","18607","16625","161","2","Sullivan County, Indiana","18","153"
"10595","7670","4498","2835","70526","14967","8870","8579","291","55559","39284","30231","9053","70526","53130","0.4703","36.4","76297","189817","154926","5207","14710","Tippecanoe County, Indiana","18","157"
"14809","9215","1574","132","119789","26273","17523","16933","590","93516","77093","71407","5686","119789","98173","0.4444","39.8","126526","321620","284070","13724","9741","Hamilton County, Indiana","18","057"
"2907","1771","1553","129","31452","9081","5276","5103","173","22371","17554","15586","1968","31452","63431","0.4298","39.2","34347","81610","67565","1332","5732","Bartholomew County, Indiana","18","005"
"706","122","15","55","7799","2665","1564","1480","84","5134","3814","3520","294","7799","52034","0.4239","40.4","9703","19898","17395","186","218","Fulton County, Indiana","18","049"
"2476","651","137","25","18276","5125","3101","2929","172","13151","10434","9640","794","18276","56789","0.4006","40.0","20555","46734","41064","783","876","Noble County, Indiana","18","113"
"2818","2783","141","393","44200","12516","7569","7236","333","31684","23490","21531","1959","44200","55630","0.4229","39.1","50564","115007","103865","1684","1133","Clark County, Indiana","18","019"
"9278","3760","393","63","59015","14825","9733","9366","367","44190","36531","34104","2427","59015","81933","0.3918","39.4","61755","161237","144771","4466","2193","Hendricks County, Indiana","18","063"
"1905","1235","69","53","26372","8714","5359","5117","242","17658","13023","11797","1226","26372","44356","0.4197","36.8","30487","65606","59073","456","453","Grant County, Indiana","18","053"
"1248","435","273","98","16753","4889","3017","2813","204","11864","9549","8931","618","16753","51250","0.4209","40.4","19141","43340","38159","612","926","Jackson County, Indiana","18","071"
"1284","272","41","40","8776","2873","1849","1737","112","5903","4533","4086","447","8776","49543","0.4043","39.3","10183","20684","18269","85","82","Owen County, Indiana","18","119"
"1456","245","50","9","13742","4171","2631","2524","107","9571","7612","7082","530","13742","61741","0.4110","39.9","14789","33351","30346","297","138","Whitley County, Indiana","18","183"
"932","444","8","12","12033","3442","2101","2079","22","8591","6689","6108","581","12033","54286","0.3786","38.9","13342","31718","27111","332","1079","Clinton County, Indiana","18","023"
"240","707","0","0","2823","942","513","495","18","1881","1484","1373","111","2823","50375","0.3826","40.9","3256","7057","6313","9","61","Union County, Indiana","18","161"
"863","2020","72","105","18870","5909","3964","3734","230","12961","10789","9976","813","18870","68658","0.4032","38.7","20498","48946","45928","340","222","Dearborn County, Indiana","18","029"
"987","322","129","8","18781","6253","3895","3750","145","12528","9661","8921","740","18781","53610","0.4055","39.3","21157","44932","40617","333","211","Lawrence County, Indiana","18","093"
"658","349","27","0","7615","2605","1459","1436","23","5010","3853","3529","324","7615","52348","0.3985","39.3","8704","17487","16590","90","74","Perry County, Indiana","18","123"
"731","432","0","9","10155","3065","2094","2011","83","7090","5563","5248","315","10155","64196","0.4124","39.0","11508","25318","23980","93","41","Posey County, Indiana","18","129"
"898","72","6","24","8002","2635","1547","1473","74","5367","4237","3940","297","8002","54806","0.4112","40.3","9625","19962","17943","208","167","Carroll County, Indiana","18","015"
"955","185","23","62","6974","2284","1405","1363","42","4690","3664","3331","333","6974","52874","0.4318","39.6","7899","16279","14892","65","30","Fountain County, Indiana","18","045"
"718","471","19","18","8549","3045","1965","1880","85","5504","4499","3955","544","8549","51190","0.4314","38.5","11165","22947","21338","264","153","Starke County, Indiana","18","149"
"1384","415","100","26","12781","4233","2653","2523","130","8548","6661","6125","536","12781","51613","0.4064","38.4","15264","31864","29127","94","134","Greene County, Indiana","18","055"
"1245","212","7","34","10306","3148","2035","1907","128","7158","5779","5414","365","10306","67729","0.4174","39.6","11144","25390","24641","96","88","Benton County, Iowa","19","011"
"1700","3885","378","501","38210","11029","6825","6542","283","27181","20469","18316","2153","38210","63031","0.4478","38.3","41299","95694","90041","975","1089","Dubuque County, Iowa","19","061"
"274","47","8","1","3215","1071","572","566","6","2144","1561","1403","158","3215","52448","0.4083","41.9","3727","6647","6135","114","120","Pocahontas County, Iowa","19","151"
"182","91","0","33","2894","1044","666","636","30","1850","1355","1288","67","2894","48591","0.4593","39.2","3646","7091","6176","76","4","Van Buren County, Iowa","19","177"
"116","28","0","7","1598","596","301","275","26","1002","837","758","79","1598","49255","0.4291","41.7","2006","3608","3379","12","9","Adams County, Iowa","19","003"
"181","109","0","4","2649","889","539","520","19","1760","1201","1076","125","2649","52055","0.4013","41.0","3001","5446","5138","15","11","Audubon County, Iowa","19","009"
"197","118","36","0","3176","1058","604","591","13","2118","1774","1694","80","3176","63404","0.4315","40.0","3597","8811","6381","76","27","Davis County, Iowa","19","051"
"294","55","4","0","3011","1010","645","581","64","2001","1475","1308","167","3011","58427","0.4565","42.0","3446","6779","6479","24","42","Ida County, Iowa","19","093"
"393","81","0","5","3294","1041","592","587","5","2253","1708","1583","125","3294","58269","0.4093","41.4","4011","7681","7323","43","7","Monroe County, Iowa","19","135"
"614","910","112","35","12248","3431","2090","2062","28","8817","7423","6966","457","12248","69844","0.3859","38.0","12928","34404","31616","546","812","Sioux County, Iowa","19","167"
"782","146","6","18","4146","1479","859","833","26","2667","2019","1839","180","4146","52323","0.4332","39.6","5072","9000","8599","55","27","Calhoun County, Iowa","19","025"
"1309","876","326","113","19241","6377","3450","3225","225","12864","9071","8232","839","19241","53963","0.4474","38.4","22348","42212","39351","522","281","Cerro Gordo County, Iowa","19","033"
"639","242","105","3","7148","2438","1299","1259","40","4710","3455","3165","290","7148","54196","0.4164","39.8","8176","16514","15561","151","178","Hardin County, Iowa","19","083"
"337","135","6","0","3701","1258","763","730","33","2443","1893","1760","133","3701","55205","0.4504","39.6","4214","8466","7838","114","70","Lucas County, Iowa","19","117"
"572","120","6","11","3702","1266","650","633","17","2436","1857","1690","167","3702","52932","0.4108","39.3","4596","8808","8264","29","109","Palo Alto County, Iowa","19","147"
"1100","374","18","7","7743","2546","1512","1415","97","5197","4151","3912","239","7743","53501","0.3934","39.1","8373","18803","17487","413","301","Henry County, Iowa","19","087"
"1899","516","31","74","14574","4883","2933","2788","145","9691","7821","7248","573","14574","58952","0.3959","39.8","16298","35416","33914","324","115","Jasper County, Iowa","19","099"
"969","617","110","4","7767","2623","1380","1320","60","5144","3947","3450","497","7767","53852","0.4595","36.5","9134","18108","16693","134","254","Poweshiek County, Iowa","19","157"
"294","337","6","11","7510","2781","1515","1408","107","4729","3581","3237","344","7510","53152","0.4049","40.7","9122","17416","15972","192","229","Clayton County, Iowa","19","043"
"1301","376","52","46","9676","3199","1930","1905","25","6477","5272","4834","438","9676","70395","0.3864","38.0","10414","24540","23621","133","152","Bremer County, Iowa","19","017"
"294","487","82","8","4036","1325","704","693","11","2711","1963","1729","234","4036","51563","0.4333","37.8","4809","9170","8312","126","149","Emmet County, Iowa","19","063"
"275","175","20","5","4790","1595","959","935","24","3195","2579","2372","207","4790","61761","0.4012","40.6","5333","10647","10179","54","44","Hancock County, Iowa","19","081"
"574","300","19","26","8239","2788","1595","1520","75","5451","4309","3910","399","8239","55967","0.4186","40.6","9550","19200","18175","120","65","Jackson County, Iowa","19","097"
"472","881","25","53","14233","4447","2738","2656","82","9786","7351","6707","644","14233","49564","0.4199","39.1","16224","33046","31472","194","112","Lee County, Iowa","19","111"
"2823","879","68","53","19258","5201","3174","3050","124","14057","11551","10831","720","19258","77048","0.4182","38.7","20004","49498","47497","521","156","Warren County, Iowa","19","181"
"767","405","41","57","8927","2726","1637","1576","61","6201","4856","4394","462","8927","54825","0.4444","38.0","9869","21937","20546","160","266","Mahaska County, Iowa","19","123"
"1037","383","75","65","7212","2344","1241","1238","3","4868","3666","3264","402","7212","50521","0.4135","39.9","8232","15975","15034","138","201","Clay County, Iowa","19","041"
"453","80","0","52","6907","2268","1381","1350","31","4639","3755","3533","222","6907","63750","0.4305","41.3","8095","17019","16421","47","44","Delaware County, Iowa","19","055"
"515","53","21","24","3874","1221","725","679","46","2653","2167","2027","140","3874","37519","0.4620","40.7","4797","10465","8188","44","75","Bacon County, Georgia","13","005"
"742","335","28","55","6823","2284","1245","1215","30","4539","3542","3363","179","6823","38857","0.4322","40.4","8173","18645","15724","131","58","Brantley County, Georgia","13","025"
"445","190","21","0","6443","2116","1174","1131","43","4327","3129","2888","241","6443","32229","0.4845","39.2","8001","16642","13431","129","126","Ben Hill County, Georgia","13","017"
"659","135","0","47","8193","2375","1509","1495","14","5818","4651","4444","207","8193","44151","0.4470","39.9","10064","22284","19274","192","67","Burke County, Georgia","13","033"
"2393","2641","2","10","24778","7911","5200","4919","281","16867","13391","12509","882","24778","56235","0.4179","38.7","27359","66207","57551","632","438","Catoosa County, Georgia","13","047"
"895","3110","243","0","2570","310","197","197","0","2260","1819","1689","130","2570","47096","0.4658","45.4","3341","6021","5386","101","161","Chattahoochee County, Georgia","13","053"
"629","322","40","21","9260","3170","1806","1730","76","6090","4496","4123","373","9260","36807","0.4476","40.8","10981","23107","19619","66","141","Chattooga County, Georgia","13","055"
"4594","4989","1539","85","47215","12465","8537","8313","224","34750","28242","26723","1519","47215","82339","0.4004","39.2","57373","146892","126798","5353","3184","Columbia County, Georgia","13","073"
"1684","374","22","75","10084","2920","1887","1772","115","7164","5518","5341","177","10084","41481","0.4790","39.7","12216","25375","20461","116","140","Decatur County, Georgia","13","087"
"3279","1592","172","157","35679","11249","7101","6904","197","24430","19302","18042","1260","35679","48336","0.4750","38.7","40599","95194","78613","1577","2193","Floyd County, Georgia","13","115"
"11265","5716","1332","632","76753","18103","13493","13057","436","58650","52111","49663","2448","76753","107218","0.4017","39.5","80937","227772","175357","16207","16120","Forsyth County, Georgia","13","117"
"2570","473","372","115","15139","5783","3553","3381","172","9356","7536","7059","477","15139","50563","0.4348","39.0","18442","42978","33889","1051","1225","Habersham County, Georgia","13","137"
"1085","359","70","20","9853","3913","2741","2599","142","5940","4420","4144","276","9853","43204","0.4498","38.2","13168","24835","21523","257","61","Hart County, Georgia","13","147"
"3450","4347","644","148","41282","9836","5881","5592","289","31446","23217","20313","2904","41282","42441","0.5179","37.8","47654","109929","90704","1571","1317","Lowndes County, Georgia","13","185"
"514","253","4","17","6042","2794","1934","1875","59","3248","2428","2190","238","6042","49504","0.4294","39.6","9554","14033","11775","165","0","McIntosh County, Georgia","13","191"
"1168","138","7","31","8051","3161","2241","2188","53","4890","3509","3316","193","8051","37121","0.4689","40.0","9997","21019","18011","63","42","Meriwether County, Georgia","13","199"
"1472","413","6","6","9760","3388","1959","1832","127","6372","4610","4347","263","9760","54754","0.5327","38.6","11129","26086","22342","386","232","Monroe County, Georgia","13","207"
"1246","309","69","0","8937","3571","2450","2356","94","5366","4278","3926","352","8937","51606","0.4855","39.9","13148","21488","18056","279","148","Putnam County, Georgia","13","237"
"1433","161","60","5","11510","3620","2311","2135","176","7890","5389","5121","268","11510","36681","0.4751","39.1","13891","29156","24652","353","679","Sumter County, Georgia","13","261"
"52","8","0","0","593","239","185","179","6","354","242","220","22","593","37446","0.4557","39.1","1020","1609","1405","5","20","Taliaferro County, Georgia","13","265"
"147","31","0","2","2244","795","484","476","8","1449","1019","980","39","2244","37203","0.5202","39.5","2976","5225","4527","19","2","Warren County, Georgia","13","301"
"127","173","2","20","2689","966","506","486","20","1723","1314","1219","95","2689","44768","0.4417","41.0","3214","6334","5545","46","34","Wayne County, Iowa","19","185"
"2060","5104","637","575","67021","18919","10985","10176","809","48102","35504","31922","3582","67021","61183","0.4614","38.8","74232","170759","156732","3158","3129","Scott County, Iowa","19","163"
"174","183","0","0","2544","772","412","396","16","1772","1280","1228","52","2544","54754","0.4057","41.0","3128","5861","5170","62","96","Sherman County, Kansas","20","181"
"451","364","22","0","3375","850","585","564","21","2525","1941","1697","244","3375","60124","0.4769","39.4","3593","7701","6839","113","104","Thomas County, Kansas","20","193"
"193","94","10","5","2280","884","603","592","11","1396","1106","1011","95","2280","55658","0.4262","41.2","3215","5482","4962","32","41","Morris County, Kansas","20","127"
"141","35","6","0","2176","783","386","369","17","1393","1047","978","69","2176","49415","0.4012","39.9","2746","4867","4505","27","3","Rooks County, Kansas","20","163"
"86","59","0","0","873","318","169","161","8","555","437","391","46","873","53348","0.3879","42.9","1137","1963","1822","15","26","Clark County, Kansas","20","025"
"212","134","1","0","2265","796","456","446","10","1469","1117","1040","77","2265","49865","0.4152","42.5","3177","5442","4690","12","34","Harper County, Kansas","20","077"
"1918","614","153","89","13569","3306","2085","1918","167","10263","7503","6077","1426","13569","46338","0.4692","38.0","15334","32850","27607","821","1567","Lyon County, Kansas","20","111"
"998","131","8","0","2448","795","572","560","12","1653","914","855","59","2448","49917","0.3951","40.2","3157","5575","4982","28","32","Pawnee County, Kansas","20","145"
"56","0","4","0","751","298","168","168","0","453","312","290","22","751","54821","0.4270","41.5","983","1668","1514","4","2","Comanche County, Kansas","20","033"
"92","49","4","0","1217","442","273","271","2","775","583","534","49","1217","48317","0.4142","42.7","1409","2597","2259","14","8","Gove County, Kansas","20","063"
"1379","869","79","7","13290","4321","2623","2537","86","8969","6994","6548","446","13290","57982","0.3984","40.0","14775","33843","30350","318","404","Harvey County, Kansas","20","079"
"124","152","108","0","1201","377","249","246","3","824","720","653","67","1201","52599","0.4552","41.3","1567","3847","2956","183","124","Kearny County, Kansas","20","093"
"977","665","138","10","12334","3712","2158","2088","70","8622","6428","5918","510","12334","59089","0.4087","39.4","13258","27840","25728","125","186","McPherson County, Kansas","20","113"
"368","94","33","9","5204","1656","1052","1030","22","3548","2687","2515","172","5204","31893","0.4547","40.6","6324","11644","10668","72","167","Desha County, Arkansas","05","041"
"531","428","34","51","4973","2320","1395","1339","56","2653","2159","1939","220","4973","35405","0.4256","40.3","6842","12062","10486","85","32","Fulton County, Arkansas","05","049"
"311","189","0","70","5142","1627","928","907","21","3515","2700","2596","104","5142","36059","0.5110","39.1","6262","13142","11534","212","271","Howard County, Arkansas","05","061"
"3117","2931","117","213","40209","16036","9296","8758","538","24173","18067","16492","1575","40209","44777","0.4807","38.7","50869","97346","85127","1137","856","Garland County, Arkansas","05","051"
"1474","1306","46","56","16389","4526","2552","2447","105","11863","9040","8188","852","16389","39962","0.4727","40.4","20559","41376","37777","230","292","Mississippi County, Arkansas","05","093"
"3472","712","240","159","22579","6648","3997","3871","126","15931","12174","11010","1164","22579","43462","0.4696","38.4","26280","63168","55367","830","1531","Pope County, Arkansas","05","115"
"400","72","0","0","3776","1465","759","744","15","2311","1801","1751","50","3776","42660","0.4579","41.7","4558","8052","7418","7","0","Prairie County, Arkansas","05","117"
"681","906","46","76","15726","4940","3081","2956","125","10786","7920","7606","314","15726","44663","0.4700","39.4","20031","39087","35642","218","296","Union County, Arkansas","05","139"
"225","40","16","15","2932","1008","598","527","71","1924","1450","1328","122","2932","32845","0.5001","42.4","3878","6418","6004","2","27","Woodruff County, Arkansas","05","147"
"899","412","1","0","10783","4532","2829","2760","69","6251","4817","4470","347","10783","44483","0.4501","39.8","16095","24779","22584","50","116","Cleburne County, Arkansas","05","023"
"167","20","0","4","3217","1137","687","687","0","2080","1597","1567","30","3217","46684","0.4257","42.3","4131","8034","7577","10","3","Cleveland County, Arkansas","05","025"
"2211","382","3","0","6137","2200","1192","1154","38","3937","2851","2604","247","6137","34109","0.5010","40.1","7592","14380","13208","60","0","Jackson County, Arkansas","05","067"
"505","496","10","37","8094","2671","1784","1741","43","5423","4330","3970","360","8094","42860","0.4199","39.5","10533","21590","19198","194","223","Hempstead County, Arkansas","05","057"
"1051","366","18","0","7447","3255","1899","1764","135","4192","2852","2656","196","7447","34671","0.4769","39.6","9882","16967","15811","44","39","Sharp County, Arkansas","05","135"
"184","205","0","0","4787","2113","1182","1066","116","2674","2113","2043","70","4787","38188","0.4609","36.1","6919","12361","11331","76","17","Stone County, Arkansas","05","137"
"9692","9424","1142","733","87325","18604","11603","10988","615","68721","52123","44011","8112","87325","50451","0.4851","38.2","93611","230371","186918","5917","10850","Washington County, Arkansas","05","143"
"1328","1118","124","1","18435","8734","5503","5306","197","9701","7318","6658","660","18435","42260","0.4517","38.5","22887","41071","38232","559","128","Baxter County, Arkansas","05","005"
"167","232","28","23","7757","2858","1840","1793","47","4899","3807","3661","146","7757","44744","0.4694","38.9","10183","20123","18301","87","165","Ashley County, Arkansas","05","003"
"6314","1958","648","253","41375","10318","6140","5859","281","31057","23381","20905","2476","41375","47286","0.4816","39.0","45413","106293","94014","1111","1840","Craighead County, Arkansas","05","031"
"2052","1374","39","18","17254","4897","3125","3046","79","12357","10014","9234","780","17254","47056","0.4261","40.1","19007","44420","40721","48","219","Greene County, Arkansas","05","055"
"417","190","5","0","3668","1382","1010","980","30","2286","1917","1844","73","3668","48667","0.4132","38.3","4974","10248","9678","15","34","Perry County, Arkansas","05","105"
"1318","404","11","4","9526","2871","1942","1874","68","6655","5088","4836","252","9526","40921","0.4285","39.7","10998","23560","20767","45","83","Poinsett County, Arkansas","05","111"
"273","103","4","16","5885","1636","1014","957","57","4249","3482","3322","160","5885","47704","0.4595","39.3","6979","16962","12791","405","921","Sevier County, Arkansas","05","133"
"261","22","8","5","1850","765","512","504","8","1085","808","798","10","1850","46417","0.4212","39.5","2929","5147","4639","17","12","Calhoun County, Arkansas","05","013"
"2173","570","61","82","8446","2573","1479","1379","100","5873","4537","3874","663","8446","41620","0.4319","36.6","10533","22049","19816","176","178","Clark County, Arkansas","05","019"
"749","401","14","4","6463","2107","1312","1276","36","4356","3464","3190","274","6463","39993","0.4382","40.4","8005","16250","15083","42","60","Lawrence County, Arkansas","05","075"
"596","196","3","0","3333","1287","621","612","9","2046","1430","1362","68","3333","38468","0.4556","40.6","4422","6971","6325","21","2","Monroe County, Arkansas","05","095"
"504","262","28","0","8309","2817","1563","1485","78","5492","4325","4115","210","8309","42802","0.4812","40.0","9828","20767","19012","186","152","Conway County, Arkansas","05","029"
"240","78","0","0","2936","1303","736","693","43","1633","1155","1107","48","2936","38082","0.4307","36.4","4690","7740","7260","38","57","Newton County, Arkansas","05","101"
"598","221","17","2","7491","2428","1460","1398","62","5063","3777","3325","452","7491","46696","0.4807","41.5","9468","17673","16358","66","42","Arkansas County, Arkansas","05","001"
"2810","1122","437","63","26895","6692","4315","4184","131","20203","16492","15707","785","26895","59094","0.4161","40.4","29387","71226","64652","692","501","Lonoke County, Arkansas","05","085"
"432","572","87","5","11139","4344","2766","2621","145","6795","5255","4876","379","11139","46110","0.4631","39.6","13723","27746","23463","665","530","Carroll County, Arkansas","05","015"
"804","392","124","1","9388","2999","1805","1753","52","6389","4427","4114","313","9388","35348","0.4908","38.6","10990","22635","20495","19","182","St. Francis County, Arkansas","05","123"
"11692","8365","1348","1545","158051","41955","24102","23340","762","116096","80834","72473","8361","158051","51749","0.5090","39.3","184319","386447","341611","7296","6994","Pulaski County, Arkansas","05","119"
"11721","2179","1611","1177","80008","21334","14729","14194","535","58674","50370","46855","3515","80008","53672","0.4719","38.7","85251","268611","187416","26391","32427","Merced County, California","06","047"
"831","306","13","137","7643","3418","2159","2021","138","4225","3083","2780","303","7643","48820","0.4234","37.5","10411","17256","15396","471","420","Mariposa County, California","06","043"
"521","273","8","0","3616","1626","962","863","99","1990","1387","1268","119","3616","45507","0.4003","39.6","5258","8698","7035","174","398","Modoc County, California","06","049"
"45496","12478","9642","59068","394769","122004","82557","77668","4889","272765","225980","207138","18842","394769","99716","0.4672","38.1","413719","1137149","819792","152456","106928","Contra Costa County, California","06","013"
"716","487","22","59","7950","3012","1737","1680","57","4938","3040","2616","424","7950","57316","0.4104","37.5","9572","17607","15157","831","602","Inyo County, California","06","027"
"16377","3095","2552","1854","173898","49378","34065","32206","1859","124520","104187","96698","7489","173898","60704","0.4396","38.3","181748","540181","412755","47631","49106","Stanislaus County, California","06","099"
"18009","8253","4637","6277","145856","46245","29328","27013","2315","99611","81936","68928","13008","145856","74624","0.4815","37.1","157161","437669","320051","32622","41118","Santa Barbara County, California","06","083"
"3358","589","90","66","24189","8459","5380","5020","360","15730","12376","11099","1277","24189","44514","0.4656","38.4","27558","63391","55152","2279","1938","Tehama County, California","06","103"
"453","92","416","1770","4765","1454","942","887","55","3311","2161","1616","545","4765","62260","0.4150","38.4","14116","14198","10552","488","873","Mono County, California","06","051"
"3099","412","253","177","18135","5291","4113","3794","319","12844","11417","10794","623","18135","86958","0.4054","38.4","18970","60212","45981","5074","4635","San Benito County, California","06","069"
"2404","1715","246","4","13048","2747","1777","1672","105","10301","8869","8468","401","13048","72624","0.4280","40.3","14292","35690","30714","790","412","Bryan County, Georgia","13","029"
"3259","194","118","0","8279","2601","1620","1522","98","5678","4678","4301","377","8279","43471","0.5216","39.8","9429","21244","18295","276","333","Butts County, Georgia","13","035"
"2095","4167","189","43","19338","4812","3513","3370","143","14526","11977","11010","967","19338","56951","0.4535","41.9","22044","49044","41277","1048","722","Camden County, Georgia","13","039"
"736","178","33","61","4510","1530","1049","1015","34","2980","2235","2107","128","4510","46283","0.4662","38.2","5362","12189","10521","79","2","Crawford County, Georgia","13","079"
"423","111","1","12","4074","1474","748","745","3","2600","2053","1914","139","4074","30640","0.4996","39.0","4978","10158","8325","85","38","Early County, Georgia","13","099"
"1329","690","104","26","14438","4137","2543","2424","119","10301","7910","7489","421","14438","40859","0.4783","39.7","17286","39642","31103","692","477","Coffee County, Georgia","13","069"
"5125","3225","389","437","52035","13790","9652","9270","382","38245","31551","29260","2291","52035","75913","0.4190","39.8","54626","142697","122728","3298","2811","Coweta County, Georgia","13","077"
"1412","811","115","23","12021","5040","3628","3444","184","6981","5193","4584","609","12021","52625","0.4561","38.6","17130","30217","23329","391","477","Gilmer County, Georgia","13","123"
"4630","1619","367","54","31670","9345","6497","6246","251","22325","19048","18181","867","31670","61599","0.4221","39.2","33794","90570","76648","2433","869","Walton County, Georgia","13","297"
"399","66","4","9","3979","1647","849","842","7","2332","1635","1579","56","3979","37838","0.5082","39.4","5165","9754","8198","78","45","Wilkes County, Georgia","13","317"
"1348","92","45","46","7628","2429","1532","1402","130","5199","3900","3765","135","7628","39302","0.4690","38.3","9848","18900","16716","71","125","Dodge County, Georgia","13","091"
"1727","491","205","189","20561","6086","3607","3488","119","14475","12197","11514","683","20561","45865","0.4646","40.0","22614","56666","45491","1028","1453","Gordon County, Georgia","13","129"
"11049","4346","755","644","88137","23273","15868","15426","442","64864","54604","50734","3870","88137","82740","0.4078","39.8","92193","246374","205614","8169","6097","Cherokee County, Georgia","13","057"
"4093","3725","783","453","40285","13598","9455","9272","183","26687","22811","21848","963","40285","90145","0.4369","39.6","42530","111684","94028","5833","3763","Fayette County, Georgia","13","113"
"1760","493","68","0","10226","2686","1824","1802","22","7540","6317","6070","247","10226","69280","0.3970","40.1","11203","28446","24658","808","122","Lee County, Georgia","13","177"
"1761","570","15","73","11868","4566","3158","3069","89","7302","5938","5470","468","11868","67631","0.4204","39.8","13981","31090","27319","274","194","Pickens County, Georgia","13","227"
"741","357","9","29","7132","3311","2330","2280","50","3821","2884","2695","189","7132","52129","0.5604","38.8","9753","17195","14205","230","180","Greene County, Georgia","13","133"
"532","93","66","12","6217","1986","1110","1040","70","4231","3408","3203","205","6217","41854","0.4604","39.6","7419","17080","13803","34","177","Cook County, Georgia","13","075"
"1236","451","18","0","9041","3347","2348","2282","66","5694","4454","4209","245","9041","66281","0.4338","39.5","11464","24322","20632","478","264","Dawson County, Georgia","13","085"
"48731","36644","10846","39488","410576","86094","48272","45703","2569","324482","205548","174742","30806","410576","69673","0.5414","40.0","471836","1026404","811509","52622","56534","Fulton County, Georgia","13","121"
"1804","6230","1073","1112","69453","27975","19080","17699","1381","41478","31844","28549","3295","69453","62409","0.4708","37.3","87824","197924","166044","11637","10447","Hawaii County, Hawaii","15","001"
"3324","38848","12476","40274","312795","112763","81346","77333","4013","200032","156242","141585","14657","312795","85857","0.4336","39.2","350571","935813","725396","110715","68472","Honolulu County, Hawaii","15","003"
"684","1859","678","219","22658","9106","6585","6138","447","13552","10880","9786","1094","22658","83554","0.4161","38.2","31016","71049","56654","6210","4629","Kauai County, Hawaii","15","007"
"6","0","1","1","39","4","2","2","0","35","11","7","4","39","69375","0.3124","41.2","94","61","58","2","1","Kalawao County, Hawaii","15","005"
"1319","676","124","28","7711","2181","1577","1530","47","5530","4733","4517","216","7711","52935","0.4115","40.8","8747","23371","18788","539","878","Cassia County, Idaho","16","031"
"220","50","47","33","1724","473","273","262","11","1251","1050","1002","48","1724","50053","0.4175","41.1","2001","5295","3824","106","220","Lincoln County, Idaho","16","063"
"357","683","6","47","3869","1691","1220","1182","38","2178","1747","1583","164","3869","64475","0.4613","37.9","12373","10624","9340","48","23","Valley County, Idaho","16","085"
"324","1008","43","54","4397","1304","877","874","3","3093","2748","2619","129","4397","57215","0.3944","37.3","4837","13423","11786","116","58","Franklin County, Idaho","16","041"
"1155","1647","17","32","16384","5305","3477","3288","189","11079","8259","7446","813","16384","58107","0.4223","38.4","17829","39640","34984","581","84","Nez Perce County, Idaho","16","069"
"2010","6928","313","230","62304","19911","12890","12185","705","42393","33527","30240","3287","62304","57242","0.4278","37.8","70892","156102","137964","2034","952","Kootenai County, Idaho","16","055"
"1134","494","153","9","7250","2109","1482","1425","57","5141","4260","4058","202","7250","53370","0.4463","42.4","8201","20655","15404","722","762","Minidoka County, Idaho","16","067"
"2983","3089","120","72","31146","8603","5535","5253","282","22543","17755","16327","1428","31146","52919","0.4369","38.9","33282","84069","68584","2244","3143","Twin Falls County, Idaho","16","083"
"336","838","102","211","7995","2657","1629","1579","50","5338","3610","3407","203","7995","56694","0.4757","39.0","15442","22348","17694","829","955","Blaine County, Idaho","16","013"
"534","137","63","0","3205","1248","979","865","114","1957","1495","1377","118","3205","59646","0.4139","40.4","5554","7351","6332","99","87","Boise County, Idaho","16","015"
"43","138","2","13","967","366","233","226","7","601","430","421","9","967","42132","0.5235","38.0","1288","2539","2132","10","4","Butte County, Idaho","16","023"
"508","336","19","19","5469","1819","1168","1111","57","3650","3038","2729","309","5469","47204","0.4134","42.3","6231","15060","11759","334","545","Gooding County, Idaho","16","047"
"9184","20270","1903","910","173353","44093","26720","25449","1271","129260","95244","84616","10628","173353","66293","0.4615","38.3","181533","449074","390022","11954","9964","Ada County, Idaho","16","001"
"215","172","33","13","2424","870","583","567","16","1554","1293","1241","52","2424","54167","0.4051","38.4","4118","5962","5461","86","74","Bear Lake County, Idaho","16","007"
"1460","1339","124","529","14989","4550","3014","2949","65","10439","8645","8250","395","14989","55472","0.4048","38.9","16745","45590","39352","801","636","Bingham County, Idaho","16","011"
"34","60","6","0","394","136","71","71","0","258","185","169","16","394","39688","0.5179","40.8","803","1048","921","0","0","Camas County, Idaho","16","025"
"528","270","27","11","3555","1622","948","902","46","1933","1433","1221","212","3555","43915","0.4242","39.9","4625","7742","6695","62","79","Clearwater County, Idaho","16","035"
"1257","998","56","351","8791","1965","1455","1429","26","6826","5959","5597","362","8791","63048","0.3712","38.5","9369","28513","25211","215","542","Jefferson County, Idaho","16","051"
"10527","14738","2173","4957","152312","49638","30755","28389","2366","102674","76406","61266","15140","152312","52426","0.4665","36.1","162611","371607","327930","8781","8806","Lane County, Oregon","41","039"
"201","115","0","87","2730","1034","671","667","4","1696","1351","1244","107","2730","57962","0.4010","39.6","3575","6517","5695","22","29","Surry County, Virginia","51","181"
"836","270","21","37","5612","1978","1316","1264","52","3634","2852","2631","221","5612","80026","0.4549","38.1","6345","14254","12108","159","182","Clarke County, Virginia","51","043"
"703","658","20","51","12075","5235","3179","3046","133","6840","4878","4660","218","12075","43207","0.4686","39.8","18983","29803","26499","177","95","Mecklenburg County, Virginia","51","117"
"3933","948","178","83","29539","10707","7197","6937","260","18832","15004","14020","984","29539","62711","0.4100","39.3","32541","70843","63986","752","538","Augusta County, Virginia","51","015"
"1714","317","36","26","8506","3277","2288","2231","57","5229","4139","3901","238","8506","93994","0.4975","39.4","9290","21736","19876","642","155","Goochland County, Virginia","51","075"
"574","110","32","88","4949","1768","1179","1132","47","3181","2505","2398","107","4949","57895","0.4324","39.8","6079","13020","11327","155","180","Madison County, Virginia","51","113"
"4656","1768","416","123","38222","13409","8196","7906","290","24813","19399","17915","1484","38222","68948","0.4265","39.6","40924","92166","82792","2834","1577","Roanoke County, Virginia","51","161"
"925","351","26","10","6037","2462","1462","1423","39","3575","2574","2329","245","6037","44434","0.4230","37.8","8231","14453","13070","67","175","Brunswick County, Virginia","51","025"
"193","153","3","60","5148","2168","1231","1153","78","2980","2111","1958","153","5148","47227","0.4639","39.4","7396","11618","9804","342","206","Northampton County, Virginia","51","131"
"799","319","66","31","9248","3897","2462","2265","197","5351","4239","3952","287","9248","54600","0.4520","38.6","11441","22364","20053","293","148","Rockbridge County, Virginia","51","163"
"799","114","0","60","1628","493","158","158","0","1135","889","810","79","1628","29000","0.5090","40.4","1903","3913","3354","91","37","Norton city, Virginia","51","720"
"1847","276","82","70","7036","2572","1580","1539","41","4464","3154","2905","249","7036","54550","0.4236","38.1","7734","17297","14988","768","252","Colonial Heights city, Virginia","51","570"
"501","56","0","13","2367","1033","674","665","9","1334","1070","1064","6","2367","48531","0.4122","39.5","3325","5486","5062","6","7","Bland County, Virginia","51","021"
"1033","440","113","0","13264","4886","3326","3166","160","8378","6773","6472","301","13264","71110","0.4114","39.5","14884","33003","30917","457","272","Botetourt County, Virginia","51","023"
"776","915","12","59","7334","2651","1323","1261","62","4683","3237","2971","266","7334","37500","0.4741","36.5","8727","16738","14901","104","19","Bristol city, Virginia","51","520"
"2453","1275","462","218","4706","1553","933","885","48","3153","1871","1311","560","4706","57463","0.5088","31.2","5263","14696","12946","344","536","Williamsburg city, Virginia","51","830"
"473","482","107","4","12357","4954","3085","3005","80","7403","5535","5154","381","12357","44835","0.4559","39.1","16749","29645","26157","132","209","Carroll County, Virginia","51","035"
"54553","17599","10960","17063","543025","148174","95600","88851","6749","394851","304921","269693","35228","543025","67151","0.4538","37.6","570752","1510932","1145718","174292","108168","Sacramento County, California","06","067"
"12501","2836","710","1204","70974","25784","17798","16711","1087","45190","36375","33038","3337","70974","83377","0.4556","37.6","90333","187280","163172","10016","5521","El Dorado County, California","06","017"
"14007","8184","3562","3006","127155","39506","26546","24935","1611","87649","73090","66907","6183","127155","71015","0.4570","39.0","141820","417249","276744","33763","65747","Monterey County, California","06","053"
"31944","20124","11684","178167","362354","97400","57270","52842","4428","264954","176013","120816","55197","362354","112449","0.5099","40.4","397812","870863","555059","184155","99746","San Francisco County, California","06","075"
"51601","78640","36713","48043","1125286","311874","210346","196174","14172","813412","646474","560789","85685","1125286","78980","0.4627","38.6","1213891","3216326","2311304","389154","263832","San Diego County, California","06","073"
"8517","2052","1661","1192","138238","36089","24676","23857","819","102149","88161","82593","5568","138238","49687","0.4728","38.8","148994","457857","339734","31820","49186","Tulare County, California","06","107"
"6278","2786","397","1063","54679","16967","9800","8757","1043","37712","27306","21422","5884","54679","48041","0.4841","35.8","63089","135003","117851","3355","2703","Humboldt County, California","06","023"
"17","30","7","2","350","195","133","130","3","155","116","101","15","350","63750","0.4930","34.5","1767","1039","913","30","4","Alpine County, California","06","003"
"7038","969","391","264","44881","14385","10548","10210","338","30496","26482","25023","1459","44881","57585","0.4422","38.4","50677","147253","110458","8819","15774","Madera County, California","06","039"
"13320","3595","1553","3997","95818","31133","19891","17944","1947","64685","50802","42693","8109","95818","82234","0.4819","36.0","106307","272491","215842","18558","24102","Santa Cruz County, California","06","087"
"533","250","15","57","5939","2573","1582","1408","174","3366","2330","2017","313","5939","40846","0.4638","37.9","8918","12529","10809","249","160","Trinity County, California","06","105"
"88981","26500","11562","12639","724893","229418","156982","146940","10042","495475","408365","380145","28220","724893","67005","0.4572","37.8","840501","2389375","1754887","241779","183420","Riverside County, California","06","065"
"85122","25375","9537","12532","636041","171073","123846","118043","5803","464968","393514","368242","25272","636041","63362","0.4375","37.9","720757","2099054","1560893","206237","155378","San Bernardino County, California","06","071"
"13948","3731","2419","12346","105432","40263","23370","21040","2330","65169","50514","45012","5502","105432","115246","0.5178","38.3","113084","255421","204860","22008","19566","Marin County, California","06","041"
"20185","6640","1597","1906","142855","50189","32506","30824","1682","92666","75905","69592","6313","142855","89691","0.4467","37.9","164176","382926","326937","27467","13078","Placer County, California","06","061"
"6232","2308","629","421","71181","25534","16045","15064","981","45647","35324","31276","4048","71181","54667","0.4588","37.2","78634","177761","157722","4661","3832","Shasta County, California","06","089"
"22851","6130","2773","6552","149865","46380","32536","30611","1925","103485","84126","76866","7260","149865","81472","0.4207","38.1","157800","429483","328755","50383","30079","Solano County, California","06","095"
"943","175","21","14","7227","2173","1287","1251","36","5054","4385","4076","309","7227","59401","0.4554","43.3","8044","21291","14707","2171","2321","Colusa County, California","06","011"
"814","343","71","7","9414","3079","1944","1919","25","6335","4838","4690","148","9414","42151","0.4540","38.3","12333","28352","24401","77","101","Copiah County, Mississippi","28","029"
"7872","4397","592","565","88611","23511","14458","13903","555","65100","45763","41334","4429","88611","44625","0.4692","38.4","104284","236360","204791","1091","1178","Hinds County, Mississippi","28","049"
"763","233","54","0","9808","3189","2056","2013","43","6619","5018","4909","109","9808","45754","0.4218","39.3","11997","28224","24892","115","158","Union County, Mississippi","28","145"
"586","252","6","2","7834","2269","1495","1481","14","5565","4182","3913","269","7834","39246","0.4395","38.9","9893","21918","19028","99","97","Tippah County, Mississippi","28","139"
"5221","2222","384","102","28086","7235","4182","4053","129","20851","15124","12938","2186","28086","39840","0.4955","38.6","32989","74587","63057","363","765","Forrest County, Mississippi","28","035"
"3572","3728","222","183","18721","4315","2796","2662","134","14406","10380","8449","1931","18721","50272","0.5212","35.5","25653","53081","46925","713","855","Lafayette County, Mississippi","28","071"
"1291","1602","129","3","22436","6523","3567","3490","77","15913","11932","11164","768","22436","50441","0.4691","38.8","27314","57041","49063","755","365","Lowndes County, Mississippi","28","087"
"505","44","11","7","3170","1268","844","755","89","1902","1110","1088","22","3170","27313","0.4907","40.4","5182","7717","6688","0","0","Wilkinson County, Mississippi","28","157"
"304","53","0","48","4713","1721","1152","1098","54","2992","2008","1905","103","4713","32116","0.5073","40.1","5973","11230","9567","71","0","Jefferson Davis County, Mississippi","28","065"
"527","298","121","151","10180","3196","1804","1759","45","6984","5514","5256","258","10180","34943","0.5340","39.6","11716","28071","22878","128","260","Scott County, Mississippi","28","123"
"594","1359","318","0","8542","2695","1369","1344","25","5847","4122","3859","263","8542","33279","0.5346","37.9","10107","23722","20538","55","82","Yazoo County, Mississippi","28","163"
"933","315","17","0","12111","3454","2042","1913","129","8657","6202","5806","396","12111","29854","0.5283","39.0","14357","31211","26384","131","222","Bolivar County, Mississippi","28","011"
"846","764","4","47","14404","4469","2705","2646","59","9935","6111","5882","229","14404","31784","0.5209","39.6","18519","38870","33264","103","152","Pike County, Mississippi","28","113"
"640","231","23","20","6334","1967","1304","1290","14","4367","3373","3270","103","6334","45483","0.4771","39.2","7466","17626","15349","92","14","Stone County, Mississippi","28","131"
"513","114","0","0","3611","1367","708","691","17","2244","1603","1510","93","3611","31103","0.4665","39.5","4766","9478","8346","0","7","Kemper County, Mississippi","28","069"
"1462","192","4","51","8322","2555","1495","1406","89","5767","4244","3886","358","8322","30838","0.5064","38.4","9668","22128","18850","80","12","Sunflower County, Mississippi","28","133"
"203","242","981","100","11237","4210","2556","2435","121","7027","4472","4215","257","11237","29936","0.5216","38.1","14692","28724","24217","159","10","Adams County, Mississippi","28","001"
"3169","7810","437","146","62890","16070","10566","10067","499","46820","38351","35722","2629","62890","67038","0.4054","40.2","67168","177891","159083","2547","1965","DeSoto County, Mississippi","28","033"
"17286","10820","2700","28256","207257","64071","39109","37407","1702","143186","109370","101638","7732","207257","74477","0.4837","38.1","224417","556900","479416","30978","19887","Delaware County, Pennsylvania","42","045"
"1815","783","61","29","29644","10966","6482","6208","274","18678","14802","13733","1069","29644","49089","0.4240","39.9","38459","69415","64247","315","166","Somerset County, Pennsylvania","42","111"
"577","263","18","3","5044","1657","1017","958","59","3387","2839","2510","329","5044","43636","0.4537","37.8","5978","11938","10549","68","27","Madison County, Missouri","29","123"
"557","715","38","23","8207","2636","1574","1454","120","5571","4177","3886","291","8207","43276","0.4479","40.1","9580","20145","17061","88","84","Vernon County, Missouri","29","217"
"2172","1119","145","7","8395","2164","1319","1278","41","6231","4662","3564","1098","8395","44232","0.4518","37.0","9766","21562","19193","101","275","Nodaway County, Missouri","29","147"
"242","31","9","0","2686","1092","658","643","15","1594","1235","1176","59","2686","46738","0.4398","38.4","4143","7255","6670","12","5","Chariton County, Missouri","29","041"
"601","51","0","33","5426","2171","1295","1211","84","3255","2392","2054","338","5426","34316","0.4511","40.7","8116","13081","11210","32","14","Wayne County, Missouri","29","223"
"2193","748","100","33","15230","4811","2907","2822","85","10419","8116","7537","579","15230","44139","0.4863","38.6","17259","38088","33598","191","117","Scott County, Missouri","29","201"
"357","329","9","4","4895","1676","964","947","17","3219","2612","2244","368","4895","44125","0.4761","39.1","5599","11675","10364","6","19","Barton County, Missouri","29","011"
"587","353","14","20","5842","2110","1442","1348","94","3732","2728","2497","231","5842","39365","0.4477","38.0","7243","13869","11504","105","89","Cedar County, Missouri","29","039"
"917","60","3","0","6076","2200","1419","1362","57","3876","3046","2825","221","6076","54885","0.4253","39.2","8178","14466","13349","117","14","Gasconade County, Missouri","29","073"
"348","53","26","28","5845","2171","1207","1158","49","3674","2641","2458","183","5845","42746","0.3976","38.9","7671","14943","13201","47","97","Macon County, Missouri","29","121"
"361","357","6","35","4249","1736","1073","992","81","2513","1992","1821","171","4249","33601","0.4471","40.1","5481","10527","8643","66","22","Oregon County, Missouri","29","149"
"1375","211","3","0","7121","2330","1659","1545","114","4791","3791","3618","173","7121","60129","0.4004","38.8","8735","17621","16644","100","17","Ste. Genevieve County, Missouri","29","186"
"406","430","29","9","5137","2098","1407","1368","39","3039","2427","2324","103","5137","37425","0.4621","38.3","6515","13189","11101","42","0","Douglas County, Missouri","29","067"
"1456","217","52","14","9328","3348","2024","1854","170","5980","4459","4058","401","9328","45795","0.4699","39.1","10960","21427","18752","169","51","Henry County, Missouri","29","083"
"1469","1492","72","1","14787","4803","2816","2653","163","9984","8142","7675","467","14787","44742","0.4340","39.6","16694","37642","31731","153","677","Lawrence County, Missouri","29","109"
"1580","12065","1393","120","15154","2744","1772","1689","83","12410","9467","8649","818","15154","53492","0.3882","42.9","19094","39306","33192","1126","812","Pulaski County, Missouri","29","169"
"1012","622","35","32","9728","3441","2293","2172","121","6287","4705","4345","360","9728","35067","0.4769","39.2","11721","24250","20033","260","46","Texas County, Missouri","29","215"
"3286","481","14","21","15973","4948","3186","3006","180","11025","8377","7819","558","15973","56938","0.4022","38.6","18919","42177","37687","434","210","Callaway County, Missouri","29","027"
"1306","332","14","11","6397","2062","1130","1084","46","4335","3307","3094","213","6397","52735","0.4057","39.1","7509","16080","14336","76","73","Cooper County, Missouri","29","053"
"171","52","2","29","2555","824","478","467","11","1731","1299","1240","59","2555","47790","0.4356","39.1","3190","6473","5722","17","51","Gentry County, Missouri","29","075"
"2288","1143","106","47","22321","8481","5262","5129","133","13840","10299","9715","584","22321","48495","0.4523","38.9","25961","53184","47583","350","304","Washington County, Virginia","51","191"
"857","222","31","30","9286","3517","2279","2111","168","5769","4759","4267","492","9286","51792","0.4031","38.9","11747","23556","20372","200","116","Page County, Virginia","51","139"
"8382","10307","3375","19643","70598","13292","6633","6157","476","57306","34817","28345","6472","70598","100939","0.4472","41.2","76357","153892","106770","15445","14828","Alexandria city, Virginia","51","510"
"8099","6456","523","1418","54050","14501","8420","7854","566","39549","28013","24407","3606","54050","56287","0.4362","38.6","60140","129082","113420","3452","1739","Hampton city, Virginia","51","650"
"10091","14881","5155","40639","107032","18373","9831","9137","694","88659","55282","40129","15153","107032","120071","0.4409","41.9","114779","228804","171331","24729","19222","Arlington County, Virginia","51","013"
"456","563","30","58","8569","3204","2051","1921","130","5365","4084","3852","232","8569","31956","0.4675","38.9","11579","20910","18113","154","43","Buchanan County, Virginia","51","027"
"7475","6627","1108","2855","47075","10185","7689","7416","273","36890","32176","30530","1646","47075","111108","0.3674","39.4","49292","141163","119952","6967","3821","Stafford County, Virginia","51","179"
"18591","7058","1837","6512","90301","21347","10251","9218","1033","68954","40851","30763","10088","90301","47250","0.5448","37.7","100458","223952","188614","4441","4025","Richmond city, Virginia","51","760"
"353","186","4","0","4555","1648","1067","1040","27","2907","2120","1934","186","4555","51954","0.4236","39.7","5855","10894","9831","95","33","Essex County, Virginia","51","057"
"898","863","5","14","16531","6328","3809","3716","93","10203","7835","7390","445","16531","42099","0.4565","38.1","20754","40320","36058","108","160","Tazewell County, Virginia","51","185"
"1718","584","146","670","4641","886","630","563","67","3755","2998","2714","284","4641","88046","0.3784","38.9","4879","16957","9735","2545","1782","Manassas Park city, Virginia","51","685"
"1278","131","19","50","3794","1402","895","846","49","2392","1825","1664","161","3794","49487","0.4100","39.4","4797","9086","8045","69","66","Sussex County, Virginia","51","183"
"2895","750","271","730","12898","2861","1874","1843","31","10037","8180","7626","554","12898","81493","0.4018","39.1","13693","41082","27849","3553","3415","Manassas city, Virginia","51","683"
"2005","551","45","50","9912","3348","1875","1760","115","6564","4756","4392","364","9912","57165","0.4514","37.8","10840","24411","22171","284","397","Salem city, Virginia","51","775"
"384","151","0","8","4661","1877","1017","981","36","2784","2099","1953","146","4661","40573","0.4677","39.5","6345","11908","10295","68","13","Charlotte County, Virginia","51","037"
"1745","146","0","18","3647","1347","791","757","34","2300","1700","1610","90","3647","50300","0.4139","38.7","4190","8244","7339","24","12","Greensville County, Virginia","51","081"
"12879","10723","2519","2631","109983","32896","21137","19756","1381","77087","60323","53210","7113","109983","72003","0.4136","38.3","116556","273396","240979","12689","6488","Thurston County, Washington","53","067"
"213","67","0","4","1795","802","427","405","22","993","765","678","87","1795","53423","0.5152","37.7","2168","3944","3562","144","48","Columbia County, Washington","53","013"
"","","","0","6510","2539","1836","1769","67","3971","3185","3047","138","6510","17379","0.4556","33.5","8233","18447","17745","30","36","Guayanilla Municipio, Puerto Rico","72","059"
"","","","30","7061","3343","2348","2228","120","3718","2667","2595","72","7061","17319","0.4856","33.9","10842","22443","21028","33","37","Sabana Grande Municipio, Puerto Rico","72","121"
"","","","99","6255","3021","1725","1641","84","3234","2490","2387","103","6255","19030","0.5166","34.0","7649","15898","15183","82","11","Hormigueros Municipio, Puerto Rico","72","067"
"","","","9","9593","4138","2619","2460","159","5455","4437","4233","204","9593","15399","0.5233","34.0","13240","28655","26637","26","33","Utuado Municipio, Puerto Rico","72","141"
"","","","16","4271","1408","1041","1041","0","2863","2358","2273","85","4271","20442","0.4362","32.3","4963","11684","11275","0","0","Florida Municipio, Puerto Rico","72","054"
"","","","27","13374","4283","3003","2946","57","9091","6833","6623","210","13374","15037","0.5831","34.0","16165","35981","34084","141","67","Moca Municipio, Puerto Rico","72","099"
"","","","12","10036","3815","2455","2369","86","6221","4858","4499","359","10036","18189","0.4753","34.4","13301","27995","26326","72","62","Salinas Municipio, Puerto Rico","72","123"
"648","179","23","17","5026","1631","984","942","42","3395","2896","2695","201","5026","35357","0.4894","39.2","5724","11858","10020","17","66","Mississippi County, Missouri","29","133"
"424","155","9","8","3958","1784","1071","1014","57","2174","1503","1376","127","3958","31947","0.4531","38.4","5707","9151","7720","61","7","Ozark County, Missouri","29","153"
"569","59","0","36","4593","1648","1014","989","25","2945","2252","2138","114","4593","44158","0.4082","38.3","5885","12144","10669","55","16","Bollinger County, Missouri","29","017"
"7474","5495","462","190","67089","19535","12971","12563","408","47554","38165","35932","2233","67089","67204","0.4431","39.6","71863","181810","160237","3369","2751","Sumner County, Tennessee","47","165"
"461","234","23","0","3189","979","591","578","13","2210","1620","1505","115","3189","56321","0.3856","38.9","3610","9335","8070","22","9","Trousdale County, Tennessee","47","169"
"144","89","0","2","3039","1185","767","703","64","1854","1404","1299","105","3039","32167","0.4723","35.8","4340","7557","6647","49","13","Clay County, Tennessee","47","027"
"769","65","60","1","5959","2013","1056","1032","24","3946","3243","2910","333","5959","61456","0.3920","39.3","6487","14359","11976","53","34","Moultrie County, Illinois","17","139"
"506","138","29","11","6309","2155","1206","1176","30","4154","3116","2897","219","6309","47492","0.4368","39.3","7985","15234","14411","40","43","Pike County, Illinois","17","149"
"135","123","0","15","1694","754","434","434","0","940","546","533","13","1694","38056","0.4328","36.5","2806","4049","3844","29","16","Pope County, Illinois","17","151"
"5581","8643","938","3782","104105","28731","16548","15922","626","75374","53781","49245","4536","104105","55179","0.4688","38.2","120236","256193","234015","3670","2672","St. Clair County, Illinois","17","163"
"740","181","13","38","9189","3359","1987","1944","43","5830","4680","4241","439","9189","52953","0.3940","39.2","10616","21554","20629","38","57","Shelby County, Illinois","17","173"
"14373","6118","3528","5795","82369","17710","10272","9612","660","64659","42021","32723","9298","82369","52797","0.5061","35.6","92699","208115","176612","7619","15622","Champaign County, Illinois","17","019"
"100","33","2","6","1664","639","388","383","5","1025","806","771","35","1664","63009","0.4125","36.6","2875","4750","4651","28","6","Calhoun County, Illinois","17","013"
"789","184","21","11","5771","1674","847","815","32","4097","2938","2732","206","5771","52092","0.4239","38.6","6360","12872","12124","83","26","Ford County, Illinois","17","053"
"21933","6410","1774","6430","179637","48426","31129","29691","1438","131211","109203","102068","7135","179637","79394","0.4431","38.8","187967","528072","417506","37071","29470","Kane County, Illinois","17","089"
"8205","924","904","1594","40721","8687","5790","5741","49","32034","27869","26320","1549","40721","96563","0.3599","39.6","42029","125714","109478","5866","4082","Kendall County, Illinois","17","093"
"987","20","11","11","2055","613","295","295","0","1442","1170","1007","163","2055","61655","0.3958","41.3","2449","4753","4340","91","21","Brown County, Illinois","17","009"
"994","405","27","28","15946","5132","2786","2642","144","10814","8097","7338","759","15946","47519","0.4314","39.1","18274","37041","34291","202","152","Marion County, Illinois","17","121"
"508","115","2","0","5977","2137","1159","1131","28","3840","3112","2662","450","5977","48417","0.4294","39.4","7055","13415","12754","93","7","Mason County, Illinois","17","125"
"1045","335","49","15","11741","4147","2317","2188","129","7594","6001","5469","532","11741","52700","0.4164","38.8","13493","27382","25112","331","348","Iroquois County, Illinois","17","075"
"874","99","9","68","5696","1821","1112","1010","102","3875","2961","2808","153","5696","48500","0.4286","40.1","6441","13119","12225","46","11","Clay County, Illinois","17","025"
"183","25","15","4","2293","920","511","498","13","1373","1053","1008","45","2293","44076","0.5553","40.5","2741","5064","4891","17","6","Gallatin County, Illinois","17","059"
"536","539","42","54","13586","4081","2698","2582","116","9505","7863","7523","340","13586","85747","0.4253","38.7","14181","33894","32377","463","190","Monroe County, Illinois","17","133"
"437","80","0","9","6654","2290","1371","1357","14","4364","3488","3202","286","6654","50625","0.4370","38.6","7994","16809","15540","198","94","Union County, Illinois","17","181"
"7070","3760","1103","1449","114779","34377","20388","19423","965","80402","59802","54476","5326","114779","54489","0.4489","38.5","125707","281711","245994","10882","8306","Winnebago County, Illinois","17","201"
"125","47","8","9","2095","936","449","408","41","1159","934","881","53","2095","34640","0.4972","36.4","3164","5505","5169","12","26","Pulaski County, Illinois","17","153"
"484","13","51","0","2775","1041","635","622","13","1734","1292","1059","233","2775","52357","0.3828","39.6","3453","6882","6016","17","202","Schuyler County, Illinois","17","169"
"560","352","4","7","7542","2575","1402","1395","7","4967","3983","3743","240","7542","53647","0.4004","38.9","8839","17119","16158","88","28","Edgar County, Illinois","17","045"
"2874","731","142","63","18571","5624","3558","3384","174","12947","11143","10514","629","18571","69272","0.4412","39.0","20060","53129","45559","1900","2483","Boone County, Illinois","17","007"
"847","317","32","86","13698","4929","2977","2869","108","8769","6907","6415","492","13698","57436","0.4206","38.9","15682","32755","30325","434","475","Bureau County, Illinois","17","011"
"4103","897","218","165","20926","6069","3454","3295","159","14857","10588","8706","1882","20926","46202","0.5022","36.7","23495","50657","46545","399","606","Coles County, Illinois","17","029"
"1393","357","1","24","7666","2542","1356","1308","48","5124","3989","3666","323","7666","49779","0.4608","38.8","8689","16659","15478","128","33","Crawford County, Illinois","17","033"
"241","61","0","0","2413","871","588","581","7","1542","1165","1048","117","2413","63638","0.3998","40.5","3147","5714","5420","114","33","Putnam County, Illinois","17","155"
"545","49","0","0","6694","2105","1177","1167","10","4589","3344","3178","166","6694","55587","0.4206","38.3","7569","15649","14804","66","129","De Witt County, Illinois","17","039"
"2293","363","75","56","13788","4257","2283","2207","76","9531","7028","6172","856","13788","58194","0.4360","39.2","15083","31305","29505","425","243","Lee County, Illinois","17","103"
"1473","555","13","49","18875","6200","3710","3609","101","12675","10118","9246","872","18875","55159","0.4203","38.1","21738","44981","42632","226","97","Macoupin County, Illinois","17","117"
"416","156","74","22","6452","2155","1256","1210","46","4297","3165","2863","302","6452","48894","0.4302","37.9","7518","15571","14666","65","166","Richland County, Illinois","17","159"
"479","161","3","53","6020","1880","1119","1059","60","4140","3247","3001","246","6020","61763","0.3973","41.2","6651","13857","13250","76","45","Washington County, Illinois","17","189"
"18069","21464","4557","18530","219053","53143","32941","30999","1942","165910","132075","115613","16462","219053","82215","0.4257","38.4","229077","585945","461540","44826","45127","Washington County, Oregon","41","067"
"1668","1678","67","199","15800","5872","3634","3274","360","9928","7304","6349","955","15800","54886","0.4121","38.2","22447","38389","33868","768","628","Clatsop County, Oregon","41","007"
"224","45","6","7","2184","887","456","443","13","1297","858","752","106","2184","41165","0.4071","38.3","4429","4572","4390","32","6","Cameron County, Pennsylvania","42","023"
"14173","11466","2168","10799","238830","79052","51508","49311","2197","159778","129055","119482","9573","238830","89139","0.4499","39.1","250552","621003","542700","37432","15882","Bucks County, Pennsylvania","42","017"
"10472","8527","2337","3630","138714","41130","25754","24297","1457","97584","76881","69637","7244","138714","63897","0.4570","38.5","146145","359963","301086","21977","13570","Lehigh County, Pennsylvania","42","077"
"2155","403","25","67","16021","5210","3052","2906","146","10811","8207","7093","1114","16021","46680","0.4373","38.2","20542","38317","35106","208","112","Clarion County, Pennsylvania","42","031"
"1165","562","63","12","14230","4881","2907","2743","164","9349","7283","6689","594","14230","54776","0.4453","39.0","16745","34341","32507","185","86","Greene County, Pennsylvania","42","059"
"6219","6952","1387","1566","128660","44158","24962","23614","1348","84502","63287","57438","5849","128660","53473","0.4490","38.4","150090","309905","277025","8869","8446","Luzerne County, Pennsylvania","42","079"
"3309","804","56","118","26372","8780","5213","4967","246","17592","12967","11239","1728","26372","50550","0.4544","37.6","30175","64957","60825","794","466","Columbia County, Pennsylvania","42","037"
"1219","467","60","140","18427","6304","3724","3641","83","12123","9399","8510","889","18427","47603","0.4223","39.4","22686","43302","39621","182","75","Jefferson County, Pennsylvania","42","065"
"1423","410","24","50","18231","5810","3696","3539","157","12421","10071","9345","726","18231","63718","0.4023","39.2","20853","45539","40989","244","147","Perry County, Pennsylvania","42","099"
"359","79","7","4","2723","1134","660","625","35","1589","1098","965","133","2723","47407","0.4362","40.2","6370","5950","5448","40","6","Sullivan County, Pennsylvania","42","113"
"5022","3172","348","1028","69422","22249","12317","11762","555","47173","35742","31637","4105","69422","73521","0.4404","38.7","74373","162760","147981","6261","3056","Kent County, Rhode Island","44","003"
"2788","4437","345","773","49102","17213","11261","10547","714","31889","24928","22283","2645","49102","85531","0.4398","36.8","64016","125053","116123","3706","1936","Washington County, Rhode Island","44","009"
"1207","516","61","13","14810","5169","3143","2907","236","9641","7234","6798","436","14810","44226","0.4696","38.5","18288","37724","33247","424","773","Newberry County, South Carolina","45","071"
"827","521","92","57","13161","5515","3559","3383","176","7646","5774","5434","340","13161","40900","0.4993","38.8","17840","32522","28526","247","211","Clarendon County, South Carolina","45","027"
"1783","3356","812","96","41776","12325","7772","7448","324","29451","22108","20686","1422","41776","45661","0.4435","39.5","48120","102309","88582","1080","1010","Sumter County, South Carolina","45","085"
"952","552","36","24","8360","2670","1559","1528","31","5690","4068","3732","336","8360","35803","0.4741","39.3","10551","21064","18429","72","97","Barnwell County, South Carolina","45","011"
"2268","680","52","49","26484","8969","5149","4965","184","17515","13095","12130","965","26484","38448","0.4765","38.8","30798","66310","58663","590","259","Darlington County, South Carolina","45","031"
"7316","13442","1017","606","101211","26255","17544","16883","661","74956","58091","53600","4491","101211","65361","0.4486","39.6","107404","264144","231359","6293","5200","York County, South Carolina","45","091"
"1237","838","62","36","20699","5987","3611","3489","122","14712","8641","8103","538","20699","36883","0.4780","38.9","24568","56581","49896","398","343","Cherokee County, South Carolina","45","021"
"1869","743","11","17","10269","3523","2468","2304","164","6746","5210","4994","216","10269","45601","0.4589","39.6","11865","28115","22742","384","598","Jasper County, South Carolina","45","053"
"555","106","0","21","6423","2272","1456","1412","44","4151","2649","2559","90","6423","32371","0.5068","39.4","7773","15902","14024","35","81","Lee County, South Carolina","45","061"
"1118","329","12","44","9660","3645","2081","2042","39","6015","4531","4206","325","9660","38741","0.4790","38.1","12191","24397","21415","179","87","Abbeville County, South Carolina","45","001"
"145","34","1","7","1397","409","303","268","35","988","767","700","67","1397","53862","0.3886","40.4","1732","3827","3184","27","3","Lyman County, South Dakota","46","085"
"143","84","7","0","1798","616","361","355","6","1182","945","888","57","1798","65437","0.3788","43.4","2218","4260","3918","0","19","Deuel County, South Dakota","46","039"
"1088","201","96","18","10085","3304","2300","2197","103","6781","5634","5193","441","10085","49633","0.4442","40.1","11008","27679","21056","1666","2578","Glenn County, California","06","021"
"11754","1985","464","1105","85320","28657","17901","16511","1390","56663","43834","34936","8898","85320","52537","0.4944","36.2","96505","223229","195066","8506","5923","Butte County, California","06","007"
"9550","2918","495","129","43452","10532","7516","7193","323","32920","28275","26238","2037","43452","57848","0.4272","40.1","46181","133994","102087","9944","11898","Kings County, California","06","031"
"1021","357","90","67","8450","3573","2313","2081","232","4877","3432","2959","473","8450","55359","0.4667","38.1","15830","18504","17196","441","298","Plumas County, California","06","063"
"15687","5175","815","1752","105981","37753","24790","23031","1759","68228","53652","44137","9515","105981","73518","0.4496","36.1","122005","275626","236211","13407","9335","San Luis Obispo County, California","06","079"
"21415","7419","4358","4408","307906","83694","54248","51176","3072","224212","185418","171241","14177","307906","53969","0.4746","38.1","331142","973266","723887","79027","89188","Fresno County, California","06","019"
"26921","9653","4176","2760","270282","67788","44881","42602","2279","202494","169368","157824","11544","270282","53350","0.4668","38.9","298117","859905","649524","57221","84906","Kern County, California","06","029"
"74088","34851","27695","30245","1037492","309022","213902","201191","12711","728470","604755","542820","61935","1037492","90234","0.4685","38.1","1100449","3151089","2101829","493433","316796","Orange County, California","06","059"
"19258","8390","4423","4582","271040","86618","59939","56686","3253","184422","152282","139721","12561","271040","88131","0.4455","38.1","288896","840257","623147","86261","56928","Ventura County, California","06","111"
"2231","263","113","164","16942","8021","5317","4912","405","8921","7309","6779","530","16942","63158","0.4414","38.3","27995","45112","41001","1288","850","Calaveras County, California","06","009"
"4602","854","668","285","32636","10174","6883","6600","283","22462","18680","17237","1443","32636","59050","0.4530","39.0","34395","94654","69398","10139","7527","Sutter County, California","06","101"
"29840","10581","9250","44722","263543","81720","55600","52363","3237","181823","149186","132265","16921","263543","122641","0.4849","39.0","277773","763665","483876","149048","98853","San Mateo County, California","06","081"
"4203","467","181","111","22502","9685","5981","5472","509","12817","9343","8285","1058","22502","60108","0.4832","36.8","31553","50971","45857","1692","643","Tuolumne County, California","06","109"
"27399","6299","3832","5055","228567","64487","44231","42058","2173","164080","137862","128471","9391","228567","64432","0.4529","38.5","243260","732477","535955","81084","68319","San Joaquin County, California","06","077"
"2584","478","24","15","14594","6905","4620","4350","270","7689","5957","5522","435","14594","62772","0.4490","38.5","18379","34742","31388","1220","512","Amador County, California","06","005"
"145","78","20","0","1689","458","253","241","12","1231","906","874","32","1689","51155","0.3953","43.6","1939","4210","3258","104","248","Phillips County, Colorado","08","095"
"582","590","61","6","5858","2350","1644","1535","109","3508","2641","2304","337","5858","52221","0.4511","38.5","9373","13146","11262","327","156","Archuleta County, Colorado","08","007"
"42087","34506","5207","25824","301501","61480","31717","29167","2550","240021","154580","116903","37677","301501","68592","0.4909","40.0","321717","699351","558698","37030","38393","Denver County, Colorado","08","031"
"69","37","0","0","638","243","133","126","7","395","285","260","25","638","41731","0.4434","42.7","795","1462","1365","5","0","Kiowa County, Colorado","08","061"
"325","262","0","5","3225","1527","889","816","73","1698","1131","1047","84","3225","38137","0.4341","38.5","5265","6537","5787","60","63","Huerfano County, Colorado","08","055"
"78","100","13","0","1662","649","377","367","10","1013","759","709","50","1662","35878","0.4562","40.9","2258","3461","3165","28","32","Baca County, Colorado","08","009"
"492","337","0","25","2802","812","514","514","0","1990","1323","1126","197","2802","76429","0.4468","40.2","3799","5960","5445","126","49","Gilpin County, Colorado","08","047"
"323","286","22","28","3004","991","621","605","16","2013","1437","1400","37","3004","49349","0.4595","41.1","3568","6951","6036","113","168","Kit Carson County, Colorado","08","063"
"1147","814","106","515","6616","1548","871","781","90","5068","3519","2600","919","6616","56577","0.4321","37.2","11955","16755","14751","302","111","Gunnison County, Colorado","08","051"
"25","51","6","0","367","150","121","111","10","217","161","152","9","367","62188","0.3755","37.3","1335","824","738","11","0","Mineral County, Colorado","08","079"
"122","177","6","0","2163","846","666","603","63","1317","943","766","177","2163","66417","0.4666","39.6","3185","4796","4245","35","37","Ouray County, Colorado","08","091"
"107","108","6","0","967","359","207","181","26","608","395","383","12","967","43150","0.5065","39.7","1191","2290","2026","20","38","Sedgwick County, Colorado","08","115"
"17814","8318","1059","808","104671","25394","16945","16232","713","79277","66165","60280","5885","104671","74150","0.4157","39.6","109170","302837","259715","8226","10962","Weld County, Colorado","08","123"
"274","90","0","0","2214","1160","896","844","52","1054","686","659","27","2214","53119","0.4154","36.0","4408","4768","3845","127","22","Custer County, Colorado","08","027"
"73","140","14","0","1746","812","454","397","57","934","676","645","31","1746","30965","0.4988","37.9","2845","3745","3151","128","36","Costilla County, Colorado","08","023"
"16533","13144","1693","3173","120709","26498","18798","18138","660","94211","80544","75495","5049","120709","119730","0.3993","39.6","124771","334814","301505","13764","10310","Douglas County, Colorado","08","035"
"443","400","0","0","3392","595","345","254","91","2797","2133","1682","451","3392","50565","0.4414","42.1","4894","7700","6374","115","133","Lake County, Colorado","08","065"
"1418","2524","107","262","21794","6291","3997","3786","211","15503","10966","9293","1673","21794","68685","0.4703","37.6","27825","55146","49329","732","466","La Plata County, Colorado","08","067"
"587","495","421","2234","7467","2319","1451","1256","195","5148","3559","2594","965","7467","78935","0.5090","38.5","14016","17891","14337","1165","609","Pitkin County, Colorado","08","097"
"552","248","5","28","4823","1454","912","894","18","3369","2255","2052","203","4823","39123","0.4661","37.2","6806","11148","9755","30","159","Rio Grande County, Colorado","08","105"
"182","59","5","39","1767","654","382","370","12","1113","843","748","95","1767","30900","0.4527","39.9","2270","3985","3572","20","41","Bent County, Colorado","08","011"
"411","132","0","15","1301","453","275","258","17","848","682","647","35","1301","42135","0.4013","34.2","1589","4782","4372","23","90","Crowley County, Colorado","08","025"
"32","9","0","0","289","106","69","59","10","183","104","74","30","289","54625","0.3974","42.1","751","589","531","6","0","San Juan County, Colorado","08","111"
"16883","15317","2032","2832","137021","36500","23416","22146","1270","100521","80330","62224","18106","137021","71881","0.4463","37.7","148229","342248","305762","8187","7940","Larimer County, Colorado","08","069"
"1958","466","109","76","8393","2511","1518","1454","64","5882","4060","3590","470","8393","53318","0.4217","40.4","9108","21911","19309","184","394","Logan County, Colorado","08","075"
"137","510","58","339","3552","802","471","449","22","2750","1802","1443","359","3552","67038","0.5175","40.4","6886","8033","6635","296","406","San Miguel County, Colorado","08","113"
"1929","1162","0","5","10248","3826","2726","2591","135","6422","4950","4438","512","10248","66592","0.4099","38.4","13256","24332","21490","517","236","Teller County, Colorado","08","119"
"2502","275","38","38","9280","2755","2106","2034","72","6525","5695","5369","326","9280","99199","0.4013","40.5","9614","25626","23743","317","213","Elbert County, Colorado","08","039"
"730","525","32","32","6670","2500","1354","1274","80","4170","2919","2532","387","6670","41817","0.4708","38.0","8576","13640","11997","222","259","Las Animas County, Colorado","08","071"
"146","67","0","0","1518","627","329","317","12","891","665","601","64","1518","47258","0.4737","39.9","1988","3500","3146","14","58","Lincoln County, Colorado","08","073"
"1144","577","180","824","10641","2513","1764","1648","116","8128","5792","4224","1568","10641","79277","0.4050","40.2","31220","30569","23202","857","1435","Summit County, Colorado","08","117"
"1334","548","35","19","6162","1609","991","980","11","4553","3293","2786","507","6162","37515","0.4870","36.6","7024","15631","12929","517","285","Alamosa County, Colorado","08","003"
"1295","701","75","62","11883","5271","3417","3106","311","6612","4870","4630","240","11883","45269","0.4805","40.1","14827","29342","25821","643","373","Delta County, Colorado","08","029"
"1208","1666","176","24","17136","6747","4476","4241","235","10389","7990","7203","787","17136","49409","0.4364","38.0","19805","36229","33232","394","97","Fremont County, Colorado","08","043"
"1516","1129","60","61","17140","6690","4106","3999","107","10450","8224","7705","519","17140","50489","0.4518","39.1","19048","41335","34917","1156","896","Montrose County, Colorado","08","085"
"1643","945","64","11","10928","3090","1793","1719","74","7838","6471","5946","525","10928","53682","0.4076","41.0","11783","28143","22199","1402","2014","Morgan County, Colorado","08","087"
"262","67","0","18","2860","1039","562","533","29","1821","1300","1255","45","2860","38571","0.4521","38.5","4151","6566","5290","192","208","Saguache County, Colorado","08","109"
"367","436","12","0","4888","1539","804","732","72","3349","2584","2431","153","4888","41929","0.4428","42.1","5982","11879","9973","376","339","Prowers County, Colorado","08","099"
"652","142","8","0","2087","705","432","401","31","1382","1104","1035","69","2087","50094","0.4305","42.3","2373","4565","4249","41","61","Washington County, Colorado","08","121"
"539","690","55","181","5884","1617","1022","930","92","4267","3114","2670","444","5884","71198","0.4137","40.2","16780","15243","12722","251","272","Grand County, Colorado","08","049"
"866","457","36","8","7722","2624","1458","1364","94","5098","3711","3288","423","7722","38169","0.4568","38.4","8999","18104","15784","241","210","Otero County, Colorado","08","089"
"7295","3777","443","1692","27470","6415","4210","4035","175","21055","16106","13896","2210","27470","96416","0.4343","39.4","28374","67545","59179","3370","2071","Broomfield County, Colorado","08","014"
"2564","9367","524","387","91697","40414","28126","26773","1353","51283","39422","35913","3509","91697","63162","0.4505","38.7","138183","221482","195292","6735","4641","Sussex County, Delaware","10","005"
"0","55650","10288","129713","284386","62410","31003","28058","2945","221976","127994","95625","32369","284386","86420","0.5269","40.3","315176","682728","571685","40340","45524","District of Columbia, District of Columbia","11","001"
"15242","17288","6726","16090","330572","101272","60817","57747","3070","229300","166545","148754","17791","330572","69905","0.4691","37.7","367053","847650","714834","53316","37108","New Haven County, Connecticut","09","009"
"15806","15966","6936","14010","350408","105642","62367","58963","3404","244766","183393","165401","17992","350408","75148","0.4716","38.3","379602","880624","721958","74327","48557","Hartford County, Connecticut","09","003"
"9274","23553","3678","4387","351194","89358","53617","51635","1982","261836","183732","166885","16847","351194","51657","0.5115","38.7","405184","923664","779106","19300","18743","Shelby County, Tennessee","47","157"
"472","69","0","14","10711","3514","2074","1996","78","7197","5580","5117","463","10711","43305","0.4430","39.4","12997","27599","25068","21","121","Henderson County, Tennessee","47","077"
"2438","1314","191","68","20154","7109","4679","4461","218","13045","10426","9537","889","20154","49139","0.4355","39.8","24200","52725","46593","281","493","Jefferson County, Tennessee","47","089"
"455","254","5","10","5528","2010","1413","1355","58","3518","3021","2837","184","5528","49370","0.4046","39.8","6499","14579","12802","38","53","Sequatchie County, Tennessee","47","153"
"1089","440","62","0","10962","3840","2361","2285","76","7122","5523","5166","357","10962","42637","0.4531","38.5","13257","27376","24638","157","80","Carroll County, Tennessee","47","017"
"19767","29523","6067","7652","282366","60887","35713","33505","2208","221479","151474","123066","28408","282366","60388","0.4826","39.4","312366","680957","544153","27095","28622","Davidson County, Tennessee","47","037"
"207","99","5","0","3073","1142","648","619","29","1931","1516","1449","67","3073","41034","0.6083","40.8","4666","7804","6496","44","7","Perry County, Tennessee","47","135"
"968","171","0","27","4938","1857","1176","1149","27","3081","2440","2182","258","4938","49167","0.4204","39.8","5888","11997","10501","247","6","Meigs County, Tennessee","47","121"
"317","100","11","0","7181","2341","1410","1390","20","4840","3507","3337","170","7181","37905","0.4631","39.5","8420","17395","15183","175","119","Haywood County, Tennessee","47","075"
"4263","16582","1449","732","72617","13093","8416","8077","339","59524","47248","43090","4158","72617","57541","0.4162","41.2","81153","185802","163273","5069","2587","Montgomery County, Tennessee","47","125"
"311","88","13","0","4820","1806","1142","1117","25","3014","2402","2203","199","4820","40516","0.4790","40.2","6460","13169","11202","17","25","Grundy County, Tennessee","47","061"
"627","571","156","1","14060","5184","3413","3272","141","8876","6430","5924","506","14060","36716","0.4672","38.5","17600","35256","31092","134","74","Cocke County, Tennessee","47","029"
"807","233","26","1","7704","2479","1576","1504","72","5225","4182","3897","285","7704","45511","0.4749","40.2","9622","19596","17206","103","228","DeKalb County, Tennessee","47","041"
"219","60","1","46","4715","1744","1103","1045","58","2971","2207","2130","77","4715","37277","0.4372","39.4","5548","11841","10417","97","105","Lewis County, Tennessee","47","101"
"834","655","22","27","12717","4388","2619","2537","82","8329","6232","5852","380","12717","39615","0.4637","39.2","14618","29908","26748","168","212","Obion County, Tennessee","47","131"
"2079","1334","231","8","21452","6015","4201","4114","87","15437","12996","12305","691","21452","61291","0.4398","40.1","23833","60467","54225","554","156","Tipton County, Tennessee","47","167"
"1123","398","41","0","15120","4511","2768","2645","123","10609","8677","7921","756","15120","44185","0.5245","39.6","16892","36879","33064","371","68","Dyer County, Tennessee","47","045"
"8106","12212","973","1910","145213","43603","25511","24501","1010","101610","71371","63500","7871","145213","55070","0.4836","38.9","161709","356815","312435","6737","6374","Hamilton County, Tennessee","47","065"
"774","427","41","0","7383","2563","1905","1806","99","4820","3735","3433","302","7383","43306","0.4418","40.2","8880","16562","14645","27","40","Polk County, Tennessee","47","139"
"1173","153","26","0","10048","3678","2156","2017","139","6370","5118","4887","231","10048","41998","0.4502","39.8","11901","26399","23154","163","78","White County, Tennessee","47","185"
"4314","4284","313","69","66511","24160","14642","13879","763","42351","31256","28958","2298","66511","46684","0.4778","38.7","75205","155319","140337","1304","679","Sullivan County, Tennessee","47","163"
"1714","418","0","158","12559","4655","2775","2617","158","7904","6069","5290","779","12559","57714","0.4240","37.9","17488","31148","29096","587","275","Schoharie County, New York","36","095"
"1902","391","93","120","22557","7385","4402","4045","357","15172","11531","10324","1207","22557","50482","0.4234","38.6","29112","52878","49438","710","176","Fulton County, New York","36","035"
"7185","4017","930","2613","64906","18782","11030","10346","684","46124","33603","28873","4730","64906","68991","0.4294","38.1","73011","157380","144080","3899","3509","Rensselaer County, New York","36","083"
"3321","750","98","170","19015","5970","3483","3286","197","13045","9657","8689","968","19015","50407","0.4529","38.1","25754","45835","42509","726","265","Franklin County, New York","36","033"
"43030","16775","22615","563503","778932","249088","166828","159223","7605","529844","412777","369264","43513","778932","68666","0.4518","38.3","859529","2272058","1143856","586029","325623","Queens County, New York","36","081"
"3654","628","130","181","24014","8242","5135","4819","316","15772","12406","10882","1524","24014","57258","0.4065","38.6","29487","58570","54193","879","304","Washington County, New York","36","115"
"39838","60178","28141","521545","759460","203907","95332","87612","7720","555553","314366","234676","79690","759460","86553","0.5956","42.2","880085","1621173","1111711","225550","199654","New York County, New York","36","061"
"3671","445","98","267","31221","10164","6074","5644","430","21057","15972","13885","2087","31221","58377","0.4351","38.2","37077","73839","68700","818","584","Cayuga County, New York","36","011"
"6290","3121","1473","11685","100438","34290","23038","22160","878","66148","55901","52777","3124","100438","93024","0.4648","37.5","106296","322460","246386","37949","20031","Rockland County, New York","36","087"
"4908","1737","416","1007","88519","28296","15802","14879","923","60223","44500","39969","4531","88519","55522","0.4425","37.2","100373","208743","194220","5136","2548","Niagara County, New York","36","063"
"2021","772","334","62","15790","6032","3668","3505","163","9758","7256","6505","751","15790","56763","0.4362","37.9","26296","35066","32731","595","489","Essex County, New York","36","031"
"30597","8310","5492","115788","446977","164993","114001","110236","3765","281984","243451","232415","11036","446977","116100","0.4578","38.6","472572","1346804","1016953","190061","80223","Nassau County, New York","36","059"
"554","117","12","45","7324","2595","1594","1447","147","4729","3642","3171","471","7324","52327","0.4178","37.9","9795","17793","16531","188","102","Schuyler County, New York","36","097"
"1314","789","63","50","20697","7081","4424","4038","386","13616","10296","9189","1107","20697","52002","0.4329","38.9","25625","47305","44595","400","287","Chenango County, New York","36","017"
"2856","7419","1983","257","42734","10424","6156","5885","271","32310","24704","22311","2393","42734","52685","0.4207","40.9","59969","100713","91929","1989","1479","Jefferson County, New York","36","045"
"23318","9406","5228","46971","489301","167578","112060","106173","5887","321723","266783","250253","16530","489301","101031","0.4436","38.2","575960","1471674","1204859","122312","75442","Suffolk County, New York","36","103"
"1825","335","33","102","15917","4949","3172","3007","165","10968","8335","7503","832","15917","58052","0.3961","39.8","18208","37846","35615","236","416","Wyoming County, New York","36","121"
"5341","1076","342","448","46079","13520","8364","7870","494","32559","25836","22575","3261","46079","55967","0.4324","37.2","54511","117628","110144","1270","834","Oswego County, New York","36","075"
"3374","865","128","199","36720","11643","7120","6686","434","25077","19764","17880","1884","36720","59449","0.4289","38.5","41756","89743","83480","1802","671","Wayne County, New York","36","117"
"6499","2549","1208","2772","78549","25791","14089","13167","922","52758","38686","32878","5808","78549","52226","0.4652","36.5","90946","190442","170052","7058","5412","Broome County, New York","36","007"
"44","42","0","0","377","155","113","105","8","222","158","150","8","377","56339","0.4427","36.3","1461","857","762","9","0","Hinsdale County, Colorado","08","053"
"17426","9926","4666","16548","389585","117530","63070","59762","3308","272055","193799","169343","24456","389585","58121","0.4661","37.5","428362","907930","817124","33868","27800","Erie County, New York","36","029"
"2224","740","270","778","28184","9754","5823","5418","405","18430","13744","12392","1352","28184","57426","0.4654","38.7","50715","72998","63581","3346","1969","Sullivan County, New York","36","105"
"8462","5347","1142","9033","128016","36302","23187","21958","1229","91714","73144","67735","5409","128016","79944","0.4409","38.5","143252","371460","319189","23784","10655","Orange County, New York","36","071"
"1981","2062","30","45","26653","10481","6220","5825","395","16172","12208","11345","863","26653","51659","0.4544","39.4","35514","60596","53726","599","289","Haywood County, North Carolina","37","087"
"11751","9529","1559","1893","146816","41706","24077","22855","1222","105110","75056","68530","6526","146816","51569","0.5008","39.2","164902","372038","312293","9214","10335","Forsyth County, North Carolina","37","067"
"6650","15642","1314","6278","186731","56670","34011","32705","1306","130061","97304","89745","7559","186731","56128","0.4495","38.8","212899","482151","419201","17229","9222","Lake County, Indiana","18","089"
"1982","827","27","105","15382","4689","2849","2757","92","10693","8474","7603","871","15382","55522","0.3940","39.3","16643","37717","33958","175","397","Montgomery County, Indiana","18","107"
"710","661","26","113","12481","3730","2198","2148","50","8751","7058","6643","415","12481","52504","0.4228","38.3","13290","34932","27928","172","109","Adams County, Indiana","18","001"
"719","116","19","21","9584","3120","1896","1720","176","6464","5115","4721","394","9584","46175","0.4145","40.4","10825","22854","20554","71","18","Fayette County, Indiana","18","041"
"942","184","3","16","10543","3276","2121","2070","51","7267","5897","5459","438","10543","55637","0.3774","39.8","11772","25738","24515","150","36","Clay County, Indiana","18","021"
"775","240","7","0","16893","4656","2695","2610","85","12237","9335","8595","740","16893","60666","0.4219","40.6","17865","41696","38240","428","1014","Dubois County, Indiana","18","037"
"711","386","6","29","8687","2733","1710","1655","55","5954","5027","4821","206","8687","62462","0.4130","39.5","9771","22665","21208","107","136","Franklin County, Indiana","18","047"
"4125","482","99","28","28740","8297","5188","4888","300","20443","16923","15351","1572","28740","74072","0.3819","40.0","30158","74466","68417","729","649","Hancock County, Indiana","18","059"
"3440","905","328","163","34701","11248","6737","6526","211","23453","17288","15922","1366","34701","52373","0.4278","38.9","39396","81330","74252","734","548","Howard County, Indiana","18","067"
"277","137","17","4","2555","829","471","467","4","1726","1384","1325","59","2555","60128","0.3830","41.2","2841","5821","5468","40","17","Ohio County, Indiana","18","115"
"1328","274","38","23","6057","2128","1530","1470","60","3929","3159","2913","246","6057","52618","0.4146","40.1","8216","15550","13234","92","105","Parke County, Indiana","18","121"
"547","515","38","34","10229","3431","2014","1899","115","6798","5081","4597","484","10229","48036","0.4215","39.9","11705","24571","22007","114","137","Randolph County, Indiana","18","135"
"484","100","32","10","3432","1067","618","611","7","2365","1815","1654","161","3432","49488","0.4039","39.5","3930","8598","7713","34","41","Benton County, Indiana","18","007"
"745","355","9","10","6189","2477","1783","1764","19","3712","3003","2744","259","6189","61030","0.4588","38.8","8686","14931","13360","219","30","Brown County, Indiana","18","013"
"2881","979","160","4","13543","4312","2777","2595","182","9231","7344","6649","695","13543","61047","0.3851","38.2","15080","34525","31567","128","784","Putnam County, Indiana","18","133"
"892","300","74","21","10940","3283","2092","2039","53","7657","5905","5679","226","10940","47983","0.4325","40.1","12413","27577","24954","171","17","Washington County, Indiana","18","175"
"999","318","61","31","11227","3434","2067","1991","76","7793","6299","6075","224","11227","53629","0.4224","39.7","12554","32642","23513","248","443","Daviess County, Indiana","18","027"
"2378","319","25","11","18304","6219","3932","3725","207","12085","9420","8582","838","18304","49832","0.4233","39.8","21201","44895","41538","205","25","Henry County, Indiana","18","065"
"2499","649","54","66","15038","4673","2546","2440","106","10365","7952","7137","815","15038","47380","0.4363","39.2","17114","36228","32998","188","239","Knox County, Indiana","18","083"
"5821","1579","167","152","51003","16519","9823","9432","391","34484","26173","23845","2328","51003","49522","0.4305","38.5","59082","124753","112863","616","989","Madison County, Indiana","18","095"
"376","75","3","39","5129","1662","973","948","25","3467","2568","2329","239","5129","50194","0.3796","40.3","5787","12168","11507","142","31","Pike County, Indiana","18","125"
"676","100","23","10","5151","1695","1030","965","65","3456","2558","2384","174","5151","49580","0.4043","40.2","6110","12453","11387","122","34","Pulaski County, Indiana","18","131"
"1336","804","12","28","14261","4632","3036","2831","205","9629","7454","6628","826","14261","58279","0.4003","39.4","19986","34215","31205","178","237","Steuben County, Indiana","18","151"
"1628","5555","318","256","39683","10996","6682","6336","346","28687","21767","19936","1831","39683","66910","0.4373","40.9","43384","94732","84682","1463","1099","Laramie County, Wyoming","56","021"
"359","1957","439","493","9019","2302","1479","1316","163","6717","4951","3874","1077","9019","84678","0.5003","40.7","13848","23215","18771","604","881","Teton County, Wyoming","56","039"
"2180","638","50","51","10043","4191","2544","2470","74","5852","4594","4210","384","10043","41614","0.4528","41.1","13939","28041","21770","398","413","San Jacinto County, Texas","48","407"
"2300","731","7","8","14108","4959","3296","3217","79","9149","7162","6824","338","14108","52162","0.4435","41.2","17055","40474","32921","341","444","Upshur County, Texas","48","459"
"3948","467","173","139","15171","4076","2929","2749","180","11095","9213","8102","1111","15171","59642","0.4677","38.5","17020","51619","37328","1300","2505","Waller County, Texas","48","473"
"2220","533","178","0","15733","4639","3532","3430","102","11094","9492","9081","411","15733","76692","0.4294","41.7","17564","48518","41035","701","530","Wilson County, Texas","48","493"
"1623","218","96","10","7997","2371","1321","1311","10","5626","4561","4326","235","7997","48248","0.4280","41.2","9384","22835","17758","491","569","Hockley County, Texas","48","219"
"9701","4800","1308","131","56998","12062","7525","7215","310","44936","34464","31789","2675","56998","79421","0.4719","42.8","61301","166878","123402","6603","9201","Midland County, Texas","48","329"
"1867","405","41","0","8678","5007","3279","3099","180","3671","2843","2642","201","8678","53411","0.5223","39.6","15335","20835","16829","187","221","Llano County, Texas","48","299"
"3847","469","70","0","12453","4343","2650","2558","92","8110","6442","6100","342","12453","54648","0.4559","41.8","14464","31653","25668","353","491","Fannin County, Texas","48","147"
"21812","5855","3068","1996","79412","13652","8751","8549","202","65760","48004","36244","11760","79412","49181","0.5149","36.8","89824","218617","170518","7517","13691","Brazos County, Texas","48","041"
"515","752","80","0","5812","1319","806","795","11","4493","3875","3750","125","5812","63054","0.4631","43.3","6501","20597","11316","1215","1115","Gaines County, Texas","48","165"
"1228","500","6","0","7884","2551","1466","1454","12","5333","4140","3712","428","7884","47952","0.4563","41.8","10030","20803","15606","673","505","Gray County, Texas","48","179"
"1149","40","0","0","3168","1003","690","676","14","2165","1675","1570","105","3168","52045","0.4648","44.4","4166","7717","6126","93","108","Jack County, Texas","48","237"
"1022","134","15","2","7211","2917","2038","1938","100","4294","3536","3409","127","7211","52148","0.4217","40.4","9767","17952","14196","280","379","Bosque County, Texas","48","035"
"45593","44074","14095","22112","636245","157549","102922","98778","4144","478696","355683","322479","33204","636245","57157","0.4688","39.3","693478","1922572","1453376","91591","84831","Bexar County, Texas","48","029"
"82","27","0","0","1530","644","247","224","23","886","745","714","31","1530","40739","0.4084","42.7","2645","3499","2925","62","1","Baylor County, Texas","48","023"
"55697","24892","6800","3708","290229","55555","38505","37208","1297","234674","184159","166867","17292","290229","86913","0.4322","40.0","308586","830187","640367","52391","44466","Denton County, Texas","48","121"
"18770","6129","1483","1370","121438","33140","21369","20292","1077","88298","70266","64694","5572","121438","73330","0.4646","40.5","146445","327847","262350","11913","7991","Galveston County, Texas","48","167"
"79","2","0","0","301","123","93","92","1","178","150","142","8","301","68750","0.3710","41.1","426","805","699","21","0","Roberts County, Texas","48","393"
"700","559","204","0","8841","3098","1931","1919","12","5743","4628","4244","384","8841","41679","0.4555","39.1","11160","26460","19799","864","1217","Uvalde County, Texas","48","463"
"2121","2510","220","152","34076","10566","6461","6351","110","23510","17714","16683","1031","34076","50164","0.4995","40.2","39827","87808","73784","1001","919","Bowie County, Texas","48","037"
"89","0","0","0","273","109","65","60","5","164","109","102","7","273","44688","0.4897","42.7","491","601","560","12","0","Kent County, Texas","48","263"
"766","33","0","34","3123","1151","835","788","47","1972","1776","1757","19","3123","60632","0.4475","39.5","3844","8675","7209","216","70","Somervell County, Texas","48","425"
"2214","535","79","57","20626","6441","4127","4093","34","14185","11442","10892","550","20626","60339","0.4663","40.3","24752","56320","47717","238","371","Hardin County, Texas","48","199"
"867","142","35","0","6443","2825","1761","1741","20","3618","2853","2622","231","6443","43045","0.5271","40.8","9791","17136","13900","155","162","Leon County, Texas","48","289"
"406","69","22","13","5315","2015","1401","1374","27","3300","2625","2511","114","5315","40101","0.4603","40.1","7359","13729","10918","34","26","Newton County, Texas","48","351"
"601","505","363","0","3518","1161","797","760","37","2357","1856","1795","61","3518","53311","0.4465","44.4","4641","13635","9881","458","519","Reeves County, Texas","48","389"
"47549","36699","11576","19525","472361","82570","52236","49116","3120","389791","272764","220179","52585","472361","75887","0.4832","39.9","514410","1219139","907775","67609","84183","Travis County, Texas","48","453"
"83","115","0","0","1035","330","218","218","0","705","554","540","14","1035","39120","0.5212","37.9","1489","2904","2145","30","53","Collingsworth County, Texas","48","087"
"3385","610","204","8","13595","3618","2324","2217","107","9977","7497","6473","1024","13595","52742","0.4938","37.2","18181","41333","32139","756","1502","Erath County, Texas","48","143"
"141","29","0","7","489","237","159","159","0","252","165","154","11","489","43859","0.4758","43.6","778","1252","1022","0","0","Motley County, Texas","48","345"
"218","57","0","8","3423","1431","833","754","79","1992","1570","1373","197","3423","46743","0.4669","40.3","5549","8299","6170","155","48","Coleman County, Texas","48","083"
"3387","314","51","8","15682","5585","3731","3547","184","10097","8598","8076","522","15682","62599","0.4525","40.9","18655","47579","38883","1274","748","Medina County, Texas","48","325"
"4092","1172","73","167","30757","12387","8194","7893","301","18370","14909","13590","1319","30757","47355","0.4702","40.1","41246","80091","63715","806","1245","Henderson County, Texas","48","213"
"1667","897","70","30","19793","6714","3839","3743","96","13079","10140","9458","682","19793","45117","0.4750","41.0","22774","49061","40023","621","418","Lamar County, Texas","48","277"
"232","97","6","11","1783","870","580","580","0","913","717","691","26","1783","43328","0.5252","39.9","3268","4334","3438","51","51","Kimble County, Texas","48","267"
"2358","249","220","1","12625","5038","3184","3184","0","7587","5862","5415","447","12625","54971","0.5113","39.5","16206","34469","29392","513","575","Washington County, Texas","48","477"
"809","39","94","20","3247","1146","738","712","26","2101","1680","1571","109","3247","46232","0.4819","41.5","4958","8943","6945","138","141","Stephens County, Texas","48","429"
"1039","140","37","10","5573","1190","831","791","40","4383","3648","3482","166","5573","76158","0.4237","44.5","6296","17943","12616","606","1171","Andrews County, Texas","48","003"
"936","58","11","45","7364","2419","1591","1567","24","4945","3930","3847","83","7364","53577","0.4829","43.2","8998","20450","15445","407","795","Gonzales County, Texas","48","177"
"559","38","7","0","2154","721","397","393","4","1433","1186","1142","44","2154","43382","0.5022","43.8","2677","5789","4546","49","113","Lynn County, Texas","48","305"
"560","57","64","0","4503","1353","854","749","105","3150","2626","2535","91","4503","33952","0.5641","38.6","6454","14267","8460","533","1206","Zapata County, Texas","48","505"
"3140","1150","220","52","22152","9183","6433","6183","250","12969","10252","9697","555","22152","64041","0.4714","41.3","26396","57636","47995","713","350","Hood County, Texas","48","221"
"8","0","0","6","77","20","10","10","0","57","45","37","8","77","52083","0.3522","49.5","124","237","188","0","39","King County, Texas","48","269"
"2306","637","127","52","18138","5938","3965","3771","194","12200","9931","9479","452","18138","48186","0.4325","39.6","21287","49386","37324","1007","1658","Cherokee County, Texas","48","073"
"398","105","0","6","1999","729","498","491","7","1270","969","925","44","1999","51038","0.4372","40.0","2488","5183","4553","39","5","Delta County, Texas","48","119"
"4121","77","0","1","5696","2115","1330","1324","6","3581","2986","2695","291","5696","50344","0.4435","40.6","7337","12839","10609","98","142","Jones County, Texas","48","253"
"3966","2815","285","336","44953","12820","8184","7776","408","32133","24808","21889","2919","44953","66550","0.4217","37.0","49718","114847","105699","2462","1959","Windham County, Connecticut","09","015"
"6162","10261","1297","1982","107827","32937","20335","19318","1017","74890","56433","50296","6137","107827","73490","0.4425","38.1","123426","255286","225143","12082","7798","New London County, Connecticut","09","011"
"6980","2608","1006","1282","66971","21863","13483","12538","945","45108","33835","30036","3799","66971","85898","0.4462","38.6","76327","161015","144787","7225","3838","Middlesex County, Connecticut","09","007"
"9016","3926","966","1431","55683","15964","10389","9705","684","39719","31290","25970","5320","55683","87069","0.4383","36.1","59686","148476","134694","5485","4486","Tolland County, Connecticut","09","013"
"7487","25767","9275","47049","340189","102053","63979","60706","3273","238136","191417","175868","15549","340189","95645","0.5422","38.6","372565","935939","699791","93219","64125","Fairfield County, Connecticut","09","001"
"2226","260","3","36","8827","3027","1848","1682","166","5800","4502","4240","262","8827","37022","0.4277","38.3","10922","21952","18578","246","308","Washington County, Florida","12","133"
"23334","27354","7794","8296","359544","92269","56332","53027","3305","267275","193241","170168","23073","359544","55807","0.4704","39.6","407960","915341","728669","50340","28333","Duval County, Florida","12","031"
"2271","321","18","46","9115","3267","2114","2005","109","5848","4399","3884","515","9115","45921","0.4487","38.8","11051","23463","20274","374","169","Bradford County, Florida","12","007"
"12099","21433","3794","1338","230417","92648","57397","53691","3706","137769","101883","91632","10251","230417","56775","0.4505","38.0","278173","580488","479490","29200","12734","Brevard County, Florida","12","009"
"13494","8999","1214","151","74333","22099","15307","14915","392","52234","44146","41628","2518","74333","65740","0.4171","39.5","80710","208638","174830","8692","3698","Clay County, Florida","12","019"
"849","29","29","2","2175","798","438","420","18","1377","1160","1115","45","2175","50165","0.4203","43.3","3193","7102","5520","198","205","Lafayette County, Florida","12","067"
"17828","11436","2116","460","134317","60940","40285","37774","2511","73377","58205","53304","4901","134317","54513","0.4231","39.7","157039","342444","280533","17614","9011","Lake County, Florida","12","069"
"2447","3064","159","60","32603","11959","8645","8273","372","20644","17074","15679","1395","32603","69943","0.4433","39.6","38975","81911","70753","1950","643","Nassau County, Florida","12","089"
"20786","31340","5881","7467","407546","161276","90606","82631","7975","246270","170775","146412","24363","407546","54090","0.4851","39.0","509132","953053","755054","60534","33657","Pinellas County, Florida","12","103"
"23727","21130","5085","1476","235283","89797","60050","56928","3122","145486","115745","104541","11204","235283","50584","0.4452","38.6","295456","678029","542248","28589","21156","Polk County, Florida","12","105"
"14378","8276","1752","534","114761","48489","33215","30460","2755","66272","51636","47028","4608","114761","52322","0.4416","38.7","141628","310499","228983","26238","12664","St. Lucie County, Florida","12","111"
"927","401","178","49","4700","2402","1500","1372","128","2298","1864","1741","123","4700","40977","0.4343","39.4","7056","12316","8367","491","490","Glades County, Florida","12","043"
"1178","479","1482","1146","12527","3621","2556","2269","287","8906","7048","6700","348","12527","40820","0.4681","40.3","14804","40192","23765","2951","3179","Hendry County, Florida","12","051"
"4392","5469","1110","224","58612","31331","19693","18375","1318","27281","20027","18257","1770","58612","54740","0.5246","38.4","80098","152683","123345","6548","4749","Indian River County, Florida","12","061"
"3999","851","127","12","17149","6361","3658","3510","148","10788","8171","7642","529","17149","39872","0.4585","38.3","21102","40591","35442","362","200","Jackson County, Florida","12","063"
"12956","12285","1768","171","88773","31331","21513","20170","1343","57442","47777","44158","3619","88773","82252","0.4667","39.2","107258","243056","207544","11170","4869","St. Johns County, Florida","12","109"
"23978","13357","4171","2225","173668","48036","32159","30929","1230","125632","96914","86011","10903","173668","66768","0.4568","39.0","190156","458233","359434","35731","19361","Seminole County, Florida","12","117"
"4234","9071","737","877","71422","21930","13656","12985","671","49492","36882","32830","4052","71422","54316","0.4427","39.2","103059","177278","145746","5251","2998","Bay County, Florida","12","005"
"3172","5311","928","137","42121","21296","14965","14025","940","20825","17006","15303","1703","42121","54514","0.4359","37.7","51757","109347","83605","8439","2615","Flagler County, Florida","12","035"
"1988","499","48","2","5757","2318","1580","1490","90","3439","2553","2411","142","5757","47712","0.4158","38.2","9567","13110","11541","155","45","Gulf County, Florida","12","045"
"850","20","5","0","2459","812","533","523","10","1647","1183","1091","92","2459","38015","0.4305","40.3","3621","6948","5531","255","109","Liberty County, Florida","12","077"
"13386","8441","8048","1641","103141","28950","21735","20722","1013","74191","59850","54842","5008","103141","52279","0.4258","38.2","149427","350493","242677","33358","23652","Osceola County, Florida","12","097"
"2887","2973","51","85","27420","9368","5936","5554","382","18052","14027","12715","1312","27420","58093","0.4830","39.5","51996","66278","54907","2046","805","Walton County, Florida","12","131"
"3098","203","4","46","17149","5999","3591","3479","112","11150","8318","7742","576","17149","41401","0.4448","39.3","20293","42923","35660","512","699","Gadsden County, Florida","12","039"
"1351","311","46","0","5770","2282","1519","1512","7","3488","2432","2249","183","5770","47240","0.4601","39.7","6752","12079","10805","138","258","Jefferson County, Florida","12","065"
"12144","10866","1266","475","139172","67054","44323","42064","2259","72118","53546","49201","4345","139172","45371","0.4544","38.6","168985","344766","283947","15529","5861","Marion County, Florida","12","083"
"644","116","60","265","7863","2696","1836","1727","109","5167","4126","3885","241","7863","38682","0.4684","40.7","9763","25395","20713","842","876","Hardee County, Florida","12","049"
"1319","694","74","19","13904","5227","3458","3177","281","8677","6685","6202","483","13904","41760","0.4556","40.1","18679","38147","29603","1216","1183","Okeechobee County, Florida","12","093"
"52498","37498","23755","16148","461705","106532","74185","70012","4173","355173","272460","234874","37586","461705","58254","0.4848","38.9","535981","1338194","937401","132511","90574","Orange County, Florida","12","095"
"1397","225","30","2","6464","2463","1672","1581","91","4001","2975","2767","208","6464","43640","0.4266","38.8","7550","16608","13295","210","184","Gilchrist County, Florida","12","041"
"2554","351","47","4","14888","5722","4089","3919","170","9166","7265","6771","494","14888","47839","0.4590","39.6","19401","42517","35443","550","601","Suwannee County, Florida","12","121"
"17880","6505","2802","4373","97995","24506","14440","13580","860","73489","47119","36704","10415","97995","49689","0.5111","36.3","117415","262894","216109","12515","12056","Alachua County, Florida","12","001"
"1302","330","29","0","4501","1757","972","931","41","2744","1938","1800","138","4501","38568","0.4571","41.6","6017","12336","10150","127","28","Calhoun County, Florida","12","013"
"6489","8652","824","113","76891","45507","30150","27930","2220","31384","23887","21100","2787","76891","51499","0.4602","38.3","104458","177693","142911","10919","5389","Charlotte County, Florida","12","015"
"1234","308","1","2","6504","2752","1860","1787","73","3752","2938","2588","350","6504","39828","0.4751","38.1","9453","15011","12311","215","55","Dixie County, Florida","12","029"
"7485","5011","1169","145","64528","32063","19250","17480","1770","32465","24140","21981","2159","64528","61133","0.5278","38.0","80153","155929","127759","7372","4511","Martin County, Florida","12","085"
"10191","16728","2820","1337","182842","99123","62608","57539","5069","83719","61954","54406","7548","182842","62236","0.4809","38.7","240766","415664","328864","26543","14531","Sarasota County, Florida","12","115"
"12871","15433","2644","1296","145356","66243","42888","40092","2796","79113","61206","55631","5575","145356","59009","0.4709","38.7","191000","381199","299870","19624","15169","Manatee County, Florida","12","081"
"5804","5025","537","137","63681","34857","22851","21328","1523","28824","20353","18263","2090","63681","44237","0.4517","38.4","79641","142910","121423","4814","2150","Citrus County, Florida","12","017"
"2850","382","88","0","8693","2649","1765","1660","105","6044","4979","4576","403","8693","63275","0.4220","39.6","9994","25324","22500","239","56","Baker County, Florida","12","003"
"8551","10176","1000","32","63514","19196","13511","12719","792","44318","36749","34168","2581","63514","67949","0.4196","40.0","71649","165459","142835","4947","2237","Santa Rosa County, Florida","12","113"
"19959","8658","1748","2546","113658","27085","16488","15718","770","86573","61627","45996","15631","113658","53106","0.4896","36.2","130005","286368","245898","9369","7950","Leon County, Florida","12","073"
"43711","33498","31671","24825","690050","217635","134956","125046","9910","472415","353351","315630","37721","690050","59547","0.4884","38.8","823499","1914269","1129610","343047","170527","Broward County, Florida","12","011"
"2194","3936","1013","398","32068","11701","7543","6744","799","20367","14835","12054","2781","32068","70033","0.5049","40.2","53518","73835","50971","5802","3630","Monroe County, Florida","12","087"
"8605","6032","953","182","75348","34850","23299","21808","1491","40498","31959","29143","2816","75348","48812","0.4293","38.9","86898","184390","151203","8142","2542","Hernando County, Florida","12","053"
"41439","42015","17150","9628","526175","136588","87632","82116","5516","389587","286661","249818","36843","526175","58884","0.4787","39.3","580511","1410780","1047423","107793","77843","Hillsborough County, Florida","12","057"
"2298","133","88","1","7405","3030","1971","1920","51","4375","3449","3277","172","7405","40306","0.4115","40.1","11112","18108","15972","280","110","Taylor County, Florida","12","123"
"2180","309","97","4","11200","3452","2194","2028","166","7748","6520","6035","485","11200","61410","0.4175","40.9","13479","28914","25912","311","114","Wakulla County, Florida","12","129"
"854","733","6","0","8153","2593","1783","1625","158","5560","4477","4145","332","8153","43468","0.4518","39.7","9350","21094","18199","285","64","McDuffie County, Georgia","13","189"
"1025","76","10","29","6942","2534","1756","1699","57","4408","3661","3551","110","6942","66178","0.4517","40.5","7753","18322","16005","108","151","Morgan County, Georgia","13","211"
"687","249","0","10","4502","1498","968","943","25","3004","2479","2311","168","4502","51358","0.4038","40.5","5201","11587","10076","75","52","Heard County, Georgia","13","149"
"4636","1759","152","573","34087","9817","5547","5233","314","24270","16822","15477","1345","34087","39584","0.4933","38.4","40610","87791","72131","631","586","Dougherty County, Georgia","13","095"
"1269","726","54","30","10408","4791","3210","2991","219","5617","4379","4092","287","10408","47997","0.4539","38.1","17239","25238","21457","212","70","Fannin County, Georgia","13","111"
"5692","4850","1020","55","57056","13347","8773","8562","211","43709","34698","32000","2698","57056","61723","0.4327","38.6","63018","149785","126536","3789","2094","Houston County, Georgia","13","153"
"989","665","68","8","17142","5729","3568","3384","184","11413","8619","8165","454","17142","39120","0.4997","38.3","21573","46528","40499","421","283","Laurens County, Georgia","13","175"
"3048","689","99","59","24336","8047","5341","5149","192","16289","12442","11311","1131","24336","47111","0.4536","39.0","27407","64205","53439","826","652","Spalding County, Georgia","13","255"
"341","90","69","1","4668","1686","1096","1037","59","2982","2266","2222","44","4668","32405","0.4803","40.8","7280","12814","11554","5","0","Telfair County, Georgia","13","271"
"450","50","28","16","3357","1116","743","741","2","2241","1859","1773","86","3357","60553","0.4070","40.7","3747","8147","7664","24","16","Warren County, Indiana","18","171"
"525","180","4","43","6664","2132","1278","1254","24","4532","3573","3203","370","6664","50243","0.4205","39.6","7508","15322","14312","39","65","Vermillion County, Indiana","18","165"
"1689","208","53","57","10888","3306","1968","1903","65","7582","6210","5866","344","10888","59237","0.3978","38.6","11871","27373","25342","226","89","Wells County, Indiana","18","179"
"7235","7995","1625","1326","145065","37433","21494","20544","950","107632","81174","73043","8131","145065","54857","0.4458","38.5","158116","369020","317889","10296","9111","Allen County, Indiana","18","003"
"881","259","42","72","10353","2958","1941","1890","51","7395","5648","5045","603","10353","57949","0.3850","40.5","11386","26219","24190","214","268","Decatur County, Indiana","18","031"
"8187","2503","264","951","46026","13414","8034","7702","332","32612","23839","19424","4415","46026","43512","0.4811","35.9","52716","113571","102480","979","955","Delaware County, Indiana","18","035"
"2551","1654","230","259","29189","7966","5014","4713","301","21223","15840","14671","1169","29189","64468","0.4447","38.9","32809","76195","71057","985","497","Floyd County, Indiana","18","043"
"1435","907","56","17","12632","4042","2357","2222","135","8590","6523","6018","505","12632","52718","0.4525","39.1","14477","30578","28071","179","117","Jefferson County, Indiana","18","077"
"1282","163","85","42","10792","3336","2142","2100","42","7456","5754","5291","463","10792","54191","0.4172","40.5","12316","27428","24847","94","112","Jennings County, Indiana","18","079"
"8792","3057","511","357","56628","15246","9441","9228","213","41382","34057","31227","2830","56628","72440","0.4144","39.6","60915","151655","135875","2778","2506","Johnson County, Indiana","18","081"
"2260","562","28","29","13611","4432","2579","2427","152","9179","7189","6732","457","13611","50657","0.4045","39.1","15405","33568","30428","157","82","Miami County, Indiana","18","103"
"4264","660","59","33","26034","7799","5228","5002","226","18235","14904","13732","1172","26034","64335","0.4046","38.8","28394","68934","63145","535","408","Morgan County, Indiana","18","109"
"946","564","50","27","13340","3959","2412","2284","128","9381","7627","7069","558","13340","55462","0.4053","40.3","15205","33057","30468","116","384","Gibson County, Indiana","18","051"
"920","231","5","32","5573","1915","1200","1148","52","3658","2866","2687","179","5573","55356","0.3780","39.6","6085","13767","12607","93","121","Newton County, Indiana","18","111"
"588","112","54","6","7898","2606","1566","1503","63","5292","4115","3820","295","7898","47917","0.4280","39.8","9218","19273","17468","199","117","Orange County, Indiana","18","117"
"5694","8544","1356","1626","101872","29151","16557","15957","600","72721","53273","48048","5225","101872","52769","0.4689","38.0","116713","267710","232079","6328","7438","St. Joseph County, Indiana","18","141"
"3754","1514","289","86","30997","9074","5944","5690","254","21923","17815","16161","1654","30997","61366","0.4093","39.8","38526","78271","67321","1278","1837","Kosciusko County, Indiana","18","085"
"1868","395","119","105","17304","5555","3296","3098","198","11749","9493","8865","628","17304","52658","0.4334","38.9","20255","45914","38745","547","838","Marshall County, Indiana","18","099"
"444","98","7","0","4349","1342","823","774","49","3007","2460","2283","177","4349","49383","0.4329","39.7","5335","10588","9243","124","66","Switzerland County, Indiana","18","155"
"6944","4999","419","1411","75607","20829","11838","11280","558","54778","38320","33463","4857","75607","49708","0.4773","38.9","84249","178940","161167","1990","1968","Vanderburgh County, Indiana","18","163"
"437","168","35","26","5235","1777","1019","1008","11","3458","2694","2466","228","5235","43505","0.4259","39.2","6019","11857","11022","103","75","Blackford County, Indiana","18","009"
"1135","255","11","0","8971","2734","1619","1581","38","6237","5046","4635","411","8971","48700","0.4076","40.5","10637","23351","21200","65","98","Scott County, Indiana","18","143"
"11583","7268","1883","2735","55624","13048","7577","7247","330","42576","29871","22026","7845","55624","49839","0.4911","34.4","61600","145376","124912","3211","7196","Monroe County, Indiana","18","105"
"4722","3366","611","265","71718","19738","12857","12235","622","51980","40748","37830","2918","71718","57021","0.4263","38.7","79096","201957","162565","4360","5571","Elkhart County, Indiana","18","039"
"260","90","18","21","3835","1378","878","837","41","2457","1853","1715","138","3835","41662","0.4557","39.2","5560","10501","9771","23","0","Crawford County, Indiana","18","025"
"1508","310","119","84","14688","4719","2601","2493","108","9969","7452","6993","459","14688","49415","0.4200","39.2","16369","37027","31214","704","1637","Cass County, Indiana","18","017"
"24203","17443","5108","7830","372358","84760","45537","42541","2996","287598","186413","160385","26028","372358","48316","0.4839","38.9","423346","941905","779998","24584","38726","Marion County, Indiana","18","097"
"1360","1918","208","86","26644","8929","5157","4814","343","17715","13653","12406","1247","26644","46516","0.4621","39.1","31372","64974","55995","406","820","Wayne County, Indiana","18","177"
"533","95","28","3","6254","2138","1291","1252","39","4116","3230","2998","232","6254","57115","0.4157","39.4","6784","14376","13772","108","25","Butler County, Iowa","19","023"
"169","219","23","0","2945","1045","660","606","54","1900","1521","1344","177","2945","56750","0.4074","40.7","3454","6836","6357","109","56","Fremont County, Iowa","19","071"
"474","124","47","1","6259","1905","1176","1111","65","4354","3148","3021","127","6259","60910","0.4115","39.8","7195","14800","13808","344","204","Hamilton County, Iowa","19","079"
"208","98","74","18","2616","956","543","513","30","1660","1280","1116","164","2616","50431","0.4497","42.4","3105","6072","5485","65","62","Taylor County, Iowa","19","173"
"671","214","12","40","5176","1714","966","924","42","3462","2625","2266","359","5176","49900","0.4328","39.4","5942","12230","11215","146","113","Union County, Iowa","19","175"
"328","100","4","4","3172","1023","591","580","11","2149","1647","1477","170","3172","57130","0.4113","39.8","3524","7342","6980","36","18","Worth County, Iowa","19","195"
"199","77","17","9","1971","691","433","423","10","1280","981","900","81","1971","55271","0.4236","41.9","2614","4752","4495","3","60","Ringgold County, Iowa","19","159"
"511","169","2","13","3200","1113","631","606","25","2087","1587","1415","172","3200","53363","0.4298","42.1","3711","6961","6567","18","67","Adair County, Iowa","19","001"
"352","56","170","26","5173","1652","888","872","16","3521","2629","2343","286","5173","60034","0.3968","40.1","5708","11889","10969","57","148","Chickasaw County, Iowa","19","037"
"507","47","189","12","3895","1155","631","602","29","2740","2085","1798","287","3895","54427","0.4158","39.8","4265","9190","8163","122","320","Clarke County, Iowa","19","039"
"571","321","117","39","8174","3013","1724","1605","119","5161","3705","3428","277","8174","59969","0.4371","39.8","13854","16959","16092","85","81","Dickinson County, Iowa","19","059"
"7242","7013","2189","4685","59134","11761","7283","6932","351","47373","34816","25463","9353","59134","62542","0.4918","36.4","63623","146956","124385","4941","9422","Johnson County, Iowa","19","103"
"411","242","14","11","4394","1519","848","797","51","2875","2181","1998","183","4394","52881","0.4512","39.1","4883","10074","9680","38","71","Keokuk County, Iowa","19","107"
"804","92","14","31","6767","2199","1325","1279","46","4568","3521","3153","368","6767","56037","0.4172","40.4","7794","16668","14941","324","307","Tama County, Iowa","19","171"
"1508","454","214","102","14481","4376","2482","2354","128","10105","7644","7066","578","14481","46246","0.4450","39.1","16070","34814","30651","767","1382","Wapello County, Iowa","19","179"
"288","63","20","24","4192","1383","914","888","26","2809","2291","2069","222","4192","56419","0.4290","40.2","4856","10015","9161","10","253","Franklin County, Iowa","19","069"
"562","202","42","5","8726","2637","1463","1434","29","6089","4473","4247","226","8726","59212","0.4311","40.5","9492","19942","19253","134","159","Carroll County, Iowa","19","027"
"584","262","20","39","7391","2378","1318","1247","71","5013","3890","3573","317","7391","67795","0.3762","40.3","8181","18221","17625","90","112","Cedar County, Iowa","19","031"
"391","110","32","28","6903","2272","1212","1162","50","4631","3289","3041","248","6903","50406","0.4334","38.9","7580","15576","13802","389","65","Floyd County, Iowa","19","067"
"685","258","24","14","3971","1442","801","754","47","2529","1972","1730","242","3971","53050","0.3950","40.0","4544","8845","8477","103","49","Greene County, Iowa","19","073"
"398","65","35","8","4335","1416","813","753","60","2919","2391","2219","172","4335","56673","0.4373","40.5","5052","11044","9737","278","462","Louisa County, Iowa","19","115"
"221","126","16","5","4548","1390","818","780","38","3158","2694","2573","121","4548","64982","0.3649","41.4","5039","11614","11017","44","31","Lyon County, Iowa","19","119"
"1145","843","9","50","9743","4986","3449","3251","198","4757","3825","3706","119","9743","50021","0.4685","38.9","14659","22725","19504","235","89","Union County, Georgia","13","291"
"958","178","103","24","13636","5076","3105","2946","159","8560","6059","5745","314","13636","36173","0.5101","39.0","17932","33117","28272","167","401","Bladen County, North Carolina","37","017"
"3021","2339","165","156","29755","11992","7401","6915","486","17763","13622","12337","1285","29755","57194","0.4616","38.4","50219","67596","59048","972","482","Carteret County, North Carolina","37","031"
"807","135","95","64","7909","3148","1584","1432","152","4761","3447","3301","146","7909","35527","0.5274","38.7","9812","18105","15783","57","115","Bertie County, North Carolina","37","015"
"902","168","10","12","9378","3763","2385","2270","115","5615","4335","3925","410","9378","40090","0.4765","38.9","11584","22698","20128","152","138","Martin County, North Carolina","37","117"
"329","225","0","0","5936","2456","1639","1521","118","3480","2637","2502","135","5936","47162","0.4413","39.9","7155","13274","11511","155","98","Perquimans County, North Carolina","37","143"
"2324","1076","169","78","37388","13031","7873","7627","246","24357","18134","17123","1011","37388","43579","0.4498","39.1","44113","89945","78966","782","1011","Rockingham County, North Carolina","37","157"
"373","201","22","2","3933","1340","925","925","0","2593","2264","2229","35","3933","64572","0.3848","39.7","4266","10396","9338","187","86","Camden County, North Carolina","37","029"
"7862","5139","227","432","83735","24848","15582","14840","742","58887","45703","41561","4142","83735","52835","0.4529","39.1","92873","217088","186822","4129","3877","Gaston County, North Carolina","37","071"
"2806","3322","284","22","39821","15597","9470","9133","337","24224","18285","16768","1517","39821","59963","0.4648","39.3","47273","93620","82206","1747","1285","Moore County, North Carolina","37","125"
"2103","915","101","28","23332","7924","5139","4909","230","15408","12387","11660","727","23332","52623","0.4205","39.3","27805","60203","52230","765","480","Stanly County, North Carolina","37","167"
"413","414","6","0","7510","2835","1820","1771","49","4675","3616","3310","306","7510","42222","0.4367","39.2","11271","17589","15072","131","103","Yancey County, North Carolina","37","199"
"2936","1097","190","216","29033","11544","7310","6751","559","17489","14109","13425","684","29033","67031","0.4833","39.7","32224","70728","58564","2220","1684","Chatham County, North Carolina","37","037"
"7381","4303","531","200","68968","17400","11417","11184","233","51568","41956","39303","2653","68968","59865","0.4231","39.4","75438","195340","164338","2917","4648","Johnston County, North Carolina","37","101"
"1181","348","100","61","15896","5325","3339","3199","140","10571","8056","7496","560","15896","51020","0.4322","39.6","18503","38957","35062","321","182","Person County, North Carolina","37","145"
"374","82","108","10","11938","4526","2700","2591","109","7412","5801","5303","498","11938","40962","0.4441","38.4","17738","26597","22775","298","184","Ashe County, North Carolina","37","009"
"2198","699","126","156","23148","8141","4366","4169","197","15007","11499","10694","805","23148","39402","0.4799","39.1","27607","55509","47535","615","402","Lenoir County, North Carolina","37","107"
"6104","24043","2981","345","64386","12233","7827","7393","434","52153","42304","38317","3987","64386","50278","0.4098","43.9","79281","157477","138778","3570","1796","Onslow County, North Carolina","37","133"
"1881","1891","99","44","26683","10077","5873","5441","432","16606","12329","11527","802","26683","42608","0.4672","39.3","34401","65610","56696","914","448","Rutherford County, North Carolina","37","161"
"1241","312","67","9","15425","5176","3150","3088","62","10249","8133","7701","432","15425","44682","0.4352","39.9","17432","37326","32338","318","630","Yadkin County, North Carolina","37","197"
"3268","1212","272","152","35156","12244","7656","7411","245","22912","17465","16169","1296","35156","44557","0.4569","38.6","41253","87554","73991","2039","957","Burke County, North Carolina","37","023"
"305","292","7","14","3383","1054","547","544","3","2329","1710","1572","138","3383","64453","0.3987","40.0","3846","7778","7259","36","61","Traill County, North Dakota","38","097"
"171","132","17","17","2119","638","382","371","11","1481","1074","961","113","2119","65492","0.4081","40.9","2654","4808","4490","35","65","Dickey County, North Dakota","38","021"
"1490","3908","905","183","28277","5992","3144","2999","145","22285","16169","13830","2339","28277","68871","0.4130","41.1","32982","64190","57551","758","1791","Ward County, North Dakota","38","101"
"222","138","23","3","3158","1131","672","659","13","2027","1459","1321","138","3158","64549","0.4384","40.8","3865","6770","6071","141","72","Pembina County, North Dakota","38","067"
"174","49","6","0","1073","428","231","229","2","645","484","457","27","1073","60164","0.4856","41.6","1480","2373","2148","7","21","Hettinger County, North Dakota","38","041"
"4134","12219","988","790","75843","14574","8136","7777","359","61269","43527","34643","8884","75843","64482","0.4654","38.6","81887","175452","154480","4452","6349","Cass County, North Dakota","38","017"
"36","16","4","1","1585","650","339","321","18","935","703","647","56","1585","55902","0.4502","44.6","2207","3256","3050","32","14","Emmons County, North Dakota","38","029"
"729","974","28","0","6777","1916","1074","1041","33","4861","3763","3242","521","6777","61371","0.4343","39.5","7737","16094","15407","98","39","Richland County, North Dakota","38","077"
"51","33","0","0","1035","378","190","186","4","657","465","442","23","1035","56681","0.4448","40.9","1429","2244","1988","0","27","Adams County, North Dakota","38","001"
"93","28","0","0","1062","385","206","187","19","677","499","459","40","1062","54868","0.4968","42.3","1327","2222","2085","0","7","Eddy County, North Dakota","38","027"
"258","189","7","5","3709","1065","630","626","4","2644","2071","1913","158","3709","82181","0.3881","40.3","4794","8329","7014","33","30","Mercer County, North Dakota","38","057"
"114","123","16","0","2371","784","366","351","15","1587","1193","1083","110","2371","63903","0.4093","41.8","2681","5162","4790","73","123","Ransom County, North Dakota","38","073"
"79","188","4","7","1112","244","178","168","10","868","705","652","53","1112","38939","0.5093","40.4","1348","4331","2958","4","2","Sioux County, North Dakota","38","085"
"40","97","50","3","842","291","124","124","0","551","394","335","59","842","58690","0.4290","45.1","1045","1786","1612","12","0","Golden Valley County, North Dakota","38","033"
"81","4","60","4","1058","373","204","191","13","685","472","416","56","1058","52300","0.4840","43.6","1437","2192","1907","6","23","Towner County, North Dakota","38","095"
"29","66","20","0","1061","427","253","250","3","634","417","400","17","1061","62865","0.4865","43.1","1557","2244","1973","34","8","Divide County, North Dakota","38","023"
"72","70","21","4","1864","580","331","331","0","1284","938","830","108","1864","63073","0.3836","41.4","2130","3834","3564","52","71","Sargent County, North Dakota","38","081"
"618","635","31","33","9045","3039","1949","1863","86","6006","4588","4253","335","9045","44899","0.4696","38.6","11192","22872","21275","19","16","Meigs County, Ohio","39","105"
"2316","404","71","0","15159","4797","2952","2858","94","10362","8293","7508","785","15159","60112","0.3758","39.8","16786","38367","36216","229","117","Champaign County, Ohio","39","021"
"10703","7015","1304","380","65604","19279","12165","11683","482","46325","35117","31026","4091","65604","68720","0.4448","37.2","70344","162702","148494","4044","3328","Greene County, Ohio","39","057"
"560","1112","87","31","23221","7744","4661","4518","143","15477","11720","10731","989","23221","45118","0.4538","37.6","27543","59601","55797","271","220","Lawrence County, Ohio","39","087"
"626","29","25","21","6108","2076","1246","1167","79","4032","3077","2873","204","6108","42341","0.4436","39.0","7980","14451","13281","39","20","Morgan County, Ohio","39","115"
"701","139","57","22","9081","2772","1710","1640","70","6309","5021","4492","529","9081","55767","0.4085","39.7","9949","21743","20442","150","68","Wyandot County, Ohio","39","175"
"2277","1346","63","404","31183","10922","6778","6341","437","20261","15022","13624","1398","31183","54226","0.4660","38.7","37860","73870","69147","866","377","Erie County, Ohio","39","043"
"1227","594","109","48","18677","5684","3501","3332","169","12993","10190","9364","826","18677","56754","0.4256","39.9","23410","44910","41656","277","263","Logan County, Ohio","39","091"
"15771","6766","1707","4001","224726","67760","39304","37273","2031","156966","112313","99928","12385","224726","57181","0.4743","38.4","245989","535722","480919","13487","10870","Summit County, Ohio","39","153"
"231","522","14","4","3582","1685","932","918","14","1897","1241","1160","81","3582","39324","0.4323","41.9","4877","7778","6698","74","94","Lemhi County, Idaho","16","059"
"616","1026","104","5","8876","3064","1926","1800","126","5812","4527","4217","310","8876","50579","0.4412","41.1","9454","23106","19214","474","519","Payette County, Idaho","16","075"
"346","282","7","23","3418","1348","998","893","105","2070","1560","1415","145","3418","47556","0.4029","40.3","4733","9056","7931","61","30","Benewah County, Idaho","16","009"
"798","2639","71","180","17537","7007","4803","4534","269","10530","8046","7450","596","17537","50256","0.4436","36.7","25121","43326","37965","515","393","Bonner County, Idaho","16","017"
"41","66","0","0","290","107","66","66","0","183","126","124","2","290","46154","0.3430","48.2","562","913","573","22","40","Clark County, Idaho","16","033"
"235","53","2","18","1774","865","581","581","0","909","554","531","23","1774","40875","0.4454","40.0","3277","4150","3761","7","2","Custer County, Idaho","16","037"
"739","1775","534","43","10606","2601","1712","1609","103","8005","6211","5441","770","10606","46855","0.3976","41.6","12489","23992","19159","953","576","Elmore County, Idaho","16","039"
"730","346","131","36","4347","1472","1098","1086","12","2875","2583","2493","90","4347","58065","0.4028","39.9","8983","12468","10663","104","204","Fremont County, Idaho","16","043"
"1800","4533","733","123","11016","1638","1084","1058","26","9378","8629","8019","610","11016","39160","0.4795","31.9","14227","38903","35029","619","944","Madison County, Idaho","16","065"
"505","531","39","21","5466","2041","1222","1132","90","3425","2579","2341","238","5466","39386","0.4429","38.9","7129","12458","10472","56","74","Shoshone County, Idaho","16","079"
"956","393","15","30","6407","2900","1933","1766","167","3507","2721","2588","133","6407","41516","0.4286","39.3","8772","15831","13953","120","35","Idaho County, Idaho","16","049"
"280","962","141","45","3707","780","463","392","71","2927","2358","2076","282","3707","74216","0.3995","40.2","5833","11426","10025","206","421","Teton County, Idaho","16","081"
"359","236","42","0","2633","743","555","548","7","1890","1290","1234","56","2633","48823","0.4024","42.9","3017","7622","5821","307","405","Power County, Idaho","16","077"
"335","418","11","21","4035","1626","1085","1025","60","2409","1819","1683","136","4035","40992","0.4444","39.6","4643","9961","8037","128","299","Washington County, Idaho","16","087"
"282","411","16","27","7409","2768","1629","1555","74","4641","3584","3382","202","7409","52561","0.4286","40.5","9255","17784","17037","150","55","Hancock County, Illinois","17","067"
"8374","5924","634","1859","107659","31609","18333","17470","863","76050","58924","52516","6408","107659","60738","0.4416","38.1","119392","262150","243875","3290","1907","Madison County, Illinois","17","119"
"1933","469","37","139","19676","4824","3046","2953","93","14852","11996","11063","933","19676","77350","0.3859","39.6","20923","50343","46792","986","702","Grundy County, Illinois","17","063"
"2685","1234","170","793","39796","12133","7389","7076","313","27663","21192","19190","2002","39796","58902","0.4301","38.5","45562","108580","98946","2003","1975","Kankakee County, Illinois","17","091"
"484","258","7","8","6516","2214","1290","1220","70","4302","3388","3164","224","6516","59787","0.3801","39.9","7420","15373","14784","126","13","Mercer County, Illinois","17","131"
"33523","14173","6213","35262","342791","96107","61051","59120","1931","246684","195900","180040","15860","342791","92809","0.4540","38.7","360307","923090","720853","98632","54828","DuPage County, Illinois","17","043"
"135","116","0","54","2154","832","491","475","16","1322","937","882","55","2154","36806","0.4413","39.3","3971","6181","5691","11","5","Alexander County, Illinois","17","003"
"506","101","2","0","5188","1640","1026","976","50","3548","2903","2767","136","5188","74684","0.4000","39.2","5730","12141","11746","67","11","Menard County, Illinois","17","129"
"3843","1167","68","69","45095","14071","8076","7677","399","31024","23552","21640","1912","45095","58142","0.4314","38.7","50151","106541","98662","1738","1574","LaSalle County, Illinois","17","099"
"46946","80880","37549","480559","1972108","538123","313880","299491","14389","1433985","1010754","883781","126973","1972108","64660","0.5081","38.8","2193338","5151562","3830519","509507","358386","Cook County, Illinois","17","031"
"2703","1502","248","620","43912","14091","7831","7492","339","29821","20463","18610","1853","43912","50480","0.4746","38.3","50392","103150","96663","1151","735","Macon County, Illinois","17","115"
"971","649","76","181","19739","6868","3857","3706","151","12871","9619","8926","693","19739","48805","0.4363","38.8","21965","44337","40950","610","233","Stephenson County, Illinois","17","177"
"483","197","30","39","7051","2545","1417","1390","27","4506","3394","3139","255","7051","50251","0.4049","40.1","7986","16355","14903","37","57","Wayne County, Illinois","17","191"
"1685","444","22","51","14499","4436","2880","2850","30","10063","8149","7641","508","14499","72808","0.4386","37.9","15542","38133","36131","402","81","Woodford County, Illinois","17","203"
"1756","618","42","104","16235","5905","2938","2782","156","10330","7728","7079","649","16235","42769","0.4501","38.4","18659","38438","35797","151","66","Franklin County, Illinois","17","055"
"2232","877","168","183","11408","3626","1809","1686","123","7782","5151","4227","924","11408","44471","0.4685","34.6","14426","30084","27715","414","654","McDonough County, Illinois","17","109"
"9647","4096","761","3992","112453","30427","19794","19284","510","82026","69100","64096","5004","112453","86799","0.4028","39.2","118464","306363","267889","14920","7557","McHenry County, Illinois","17","111"
"17","9","17","0","519","163","98","94","4","356","258","244","14","519","54112","0.3982","44.2","633","1154","1002","55","33","Greeley County, Kansas","20","071"
"1909","1199","156","45","11544","3068","1522","1513","9","8476","6084","4986","1098","11544","52883","0.4840","38.1","13254","28547","25817","331","400","Ellis County, Kansas","20","051"
"256","185","3","8","4497","1611","988","936","52","2886","2194","2049","145","4497","48778","0.4575","41.6","5616","9612","8588","24","5","Linn County, Kansas","20","107"
"452","562","82","30","7321","1500","902","886","16","5821","4713","4345","368","7321","49291","0.4053","40.2","8240","22151","13403","1973","2552","Seward County, Kansas","20","175"
"12545","24520","3226","889","228592","57261","35797","34620","1177","171331","133399","121515","11884","228592","89087","0.4465","39.5","241767","587461","512886","22629","17424","Johnson County, Kansas","20","091"
"1562","307","67","20","12835","3928","2471","2379","92","8907","7169","6760","409","12835","71995","0.4247","40.6","13719","32744","30592","131","88","Miami County, Kansas","20","121"
"144","31","0","0","1434","600","331","325","6","834","630","541","89","1434","39643","0.4390","39.7","2021","3149","2732","5","0","Woodson County, Kansas","20","207"
"55","26","2","1","1269","479","243","243","0","790","647","598","49","1269","56492","0.4699","41.6","1712","2831","2514","41","52","Ness County, Kansas","20","135"
"192","457","5","0","5636","1936","1057","1024","33","3700","3005","2767","238","5636","43917","0.4397","38.9","7114","14383","12684","149","18","Bourbon County, Kansas","20","011"
"66","37","8","2","985","355","212","195","17","630","470","449","21","985","53274","0.3958","38.8","1232","2439","2147","29","12","Kiowa County, Kansas","20","097"
"5962","2870","482","986","72267","21826","12103","11537","566","50441","36264","32701","3563","72267","56762","0.4420","38.7","80012","174349","157232","2550","2736","Shawnee County, Kansas","20","177"
"153","16","0","0","1456","601","331","318","13","855","634","582","52","1456","40298","0.4374","40.5","2148","3272","2830","12","11","Chautauqua County, Kansas","20","019"
"3042","1076","198","81","25014","8222","4813","4606","207","16792","12373","10935","1438","25014","49936","0.4402","39.0","28495","60274","53522","402","700","Reno County, Kansas","20","155"
"246","518","3","5","3046","994","538","531","7","2052","1563","1366","197","3046","49703","0.4324","39.2","3583","7568","6806","17","42","Doniphan County, Kansas","20","043"
"98","115","36","0","1320","385","239","231","8","935","815","768","47","1320","55064","0.4562","44.9","1686","3954","2800","211","244","Haskell County, Kansas","20","081"
"432","48","0","7","1967","532","403","403","0","1435","1085","957","128","1967","65417","0.3592","45.1","2163","4807","4283","92","171","Scott County, Kansas","20","171"
"197","252","11","2","3872","1311","859","839","20","2561","1883","1739","144","3872","48333","0.4202","39.5","4751","9535","8783","13","56","Brown County, Kansas","20","013"
"110","76","2","0","2316","828","482","459","23","1488","1142","1021","121","2316","50093","0.4144","41.1","3091","5245","4857","28","56","Phillips County, Kansas","20","147"
"113","167","0","0","1442","543","265","263","2","899","599","518","81","1442","48125","0.4228","41.6","1789","2794","2495","18","0","Decatur County, Kansas","20","039"
"778","177","28","5","6706","2130","1453","1379","74","4576","3827","3565","262","6706","52631","0.4339","39.4","7491","17342","15985","153","45","Garrard County, Kentucky","21","079"
"3176","3006","348","828","36746","10127","5916","5725","191","26619","19770","17580","2190","36746","63050","0.4625","38.0","40312","91367","86289","941","792","Campbell County, Kentucky","21","037"
"805","170","0","8","2523","910","688","673","15","1613","1292","1252","40","2523","32306","0.4535","41.0","3448","5971","5651","13","0","Elliott County, Kentucky","21","063"
"455","246","18","0","5741","1775","1141","1058","83","3966","3122","2824","298","5741","47643","0.4455","37.9","6382","13912","13123","65","136","Larue County, Kentucky","21","123"
"1435","225","87","14","8556","2782","1730","1679","51","5774","4541","4243","298","8556","55093","0.4233","39.4","10147","21412","19746","93","236","Mercer County, Kentucky","21","167"
"487","205","17","39","6922","2353","1391","1305","86","4569","3443","3217","226","6922","38390","0.4391","38.3","10121","17569","16079","60","55","Russell County, Kentucky","21","207"
"574","137","5","15","4581","1343","875","843","32","3238","2607","2366","241","4581","53743","0.4192","40.4","5185","11896","10941","35","97","Washington County, Kentucky","21","229"
"1961","594","24","37","16931","4971","3093","2892","201","11960","9342","8483","859","16931","41459","0.4392","40.0","19682","43167","39868","199","204","Barren County, Kentucky","21","009"
"266","112","4","15","3311","992","726","679","47","2319","1897","1819","78","3311","57217","0.3625","40.8","3746","8652","8319","41","36","Hancock County, Kentucky","21","091"
"4678","6184","878","162","41646","10479","6536","6319","217","31167","23905","22088","1817","41646","54367","0.4354","40.2","46677","104255","95896","2437","1104","Hardin County, Kentucky","21","093"
"446","84","5","0","3809","1252","778","761","17","2557","2055","1992","63","3809","51861","0.4274","40.4","4286","9192","8554","28","14","McLean County, Kentucky","21","149"
"848","103","0","8","4770","1379","822","822","0","3391","2778","2648","130","4770","37469","0.4461","39.9","5683","12040","11352","95","39","Powell County, Kentucky","21","197"
"307","216","4","14","5163","1839","1103","1074","29","3324","2690","2475","215","5163","44775","0.5242","40.7","6291","12587","11617","65","0","Caldwell County, Kentucky","21","033"
"1260","1735","107","46","18210","6185","3965","3894","71","12025","9212","8359","853","18210","48308","0.4856","38.3","21674","45933","42729","221","234","Boyd County, Kentucky","21","019"
"14189","12807","2795","3129","129784","29653","17453","16571","882","100131","71321","58190","13131","129784","57291","0.4926","38.0","141653","315851","272097","8309","13922","Fayette County, Kentucky","21","067"
"877","319","78","16","8488","2739","1713","1694","19","5749","4256","4013","243","8488","37055","0.5063","40.1","10630","22092","20852","96","168","Johnson County, Kentucky","21","115"
"495","80","13","9","4865","1632","949","882","67","3233","2576","2386","190","4865","36134","0.4734","39.6","5961","11639","10891","9","78","Morgan County, Kentucky","21","175"
"1811","1106","66","64","25301","8136","5126","4706","420","17165","13176","12065","1111","25301","39998","0.5151","38.9","31487","63588","58801","517","454","Pulaski County, Kentucky","21","199"
"812","406","38","0","6977","2450","1524","1493","31","4527","3438","3347","91","6977","38021","0.4777","37.4","8609","18949","17627","68","237","Adair County, Kentucky","21","001"
"353","280","20","0","5358","1614","1071","1064","7","3744","2693","2525","168","5358","27344","0.5340","38.1","6358","12843","12209","33","24","Breathitt County, Kentucky","21","025"
"702","179","36","17","7351","2281","1188","1099","89","5070","3853","3680","173","7351","38396","0.4715","38.8","9077","18466","17063","43","85","Hart County, Kentucky","21","099"
"313","293","4","0","3498","1071","675","664","11","2427","1778","1626","152","3498","53056","0.4607","40.5","3993","8513","7906","50","74","Trimble County, Kentucky","21","223"
"49","67","0","0","1798","701","411","382","29","1097","765","691","74","1798","42929","0.5079","37.8","2358","4368","4110","50","5","Hickman County, Kentucky","21","105"
"545","208","30","0","3333","1509","943","915","28","1824","1273","1109","164","3333","52528","0.4355","37.1","4885","6985","6492","50","23","Lyon County, Kentucky","21","143"
"292","221","0","7","5268","1757","1080","1050","30","3511","2636","2511","125","5268","31147","0.5015","40.7","6568","13274","12571","8","19","Lewis County, Kentucky","21","135"
"1377","305","174","27","10355","3271","2269","2224","45","7084","5575","5071","504","10355","63820","0.4298","39.7","11138","26199","24070","161","658","Woodford County, Kentucky","21","239"
"378","12","21","0","4076","1404","931","868","63","2672","2022","1959","63","4076","31627","0.4562","40.2","5396","9971","9499","19","6","Leslie County, Kentucky","21","131"
"115","363","0","17","5784","1986","1239","1211","28","3798","2842","2735","107","5784","32798","0.4989","39.4","7435","15567","14189","7","29","Lawrence County, Kentucky","21","127"
"1326","1480","109","129","27854","9054","4723","4527","196","18800","13133","11714","1419","27854","46080","0.5257","38.5","32065","64024","59390","447","280","McCracken County, Kentucky","21","145"
"184","133","11","63","2231","631","355","348","7","1600","1210","1093","117","2231","57196","0.4769","43.0","2572","5086","4687","32","20","Brule County, South Dakota","46","015"
"96","142","12","0","1840","710","368","338","30","1130","817","781","36","1840","43438","0.4588","41.8","2543","4137","3713","13","4","Gregory County, South Dakota","46","053"
"7297","5152","1586","731","76819","17508","9757","9263","494","59311","43434","38342","5092","76819","61772","0.4166","39.2","81751","185832","159915","4751","6287","Minnehaha County, South Dakota","46","099"
"170","9","24","0","1546","536","304","285","19","1010","740","655","85","1546","48980","0.5155","43.7","1823","3623","3338","9","32","Clark County, South Dakota","46","025"
"270","79","6","6","2279","739","445","438","7","1540","1109","982","127","2279","61699","0.4331","42.8","2770","4855","4633","8","9","Kingsbury County, South Dakota","46","077"
"1556","1172","104","65","5233","1036","654","634","20","4197","3001","2082","919","5233","50724","0.5001","34.7","6039","13765","12447","85","372","Clay County, South Dakota","46","027"
"51","28","4","4","1651","428","265","255","10","1223","992","939","53","1651","47475","0.4525","39.0","2025","5788","4191","3","7","Dewey County, South Dakota","46","041"
"1227","475","0","88","7460","2065","1159","1142","17","5395","3630","3273","357","7460","64783","0.3997","40.4","8034","16622","15417","29","62","Hughes County, South Dakota","46","065"
"82","30","0","0","1010","297","201","194","7","713","556","517","39","1010","56875","0.4412","42.4","1215","2329","2145","12","9","Sanborn County, South Dakota","46","111"
"56","71","5","6","1508","550","309","296","13","958","738","680","58","1508","54155","0.4376","45.0","1832","3203","3038","0","19","Hand County, South Dakota","46","059"
"920","1014","95","111","9445","2545","1647","1582","65","6900","4957","4340","617","9445","58342","0.4570","39.7","10110","21388","19597","207","122","Yankton County, South Dakota","46","135"
"580","180","24","123","7557","2209","1046","1038","8","5348","3890","3552","338","7557","52313","0.4188","40.3","8500","18036","14760","644","1303","Beadle County, South Dakota","46","005"
"1608","519","46","188","8660","2448","1374","1343","31","6212","4398","3922","476","8660","50570","0.4654","40.4","9503","19545","17972","151","212","Davison County, South Dakota","46","035"
"51","29","0","11","921","385","245","233","12","536","383","339","44","921","49632","0.5526","42.5","1092","1975","1798","13","19","Jerauld County, South Dakota","46","073"
"238","54","2","25","1344","452","354","354","0","892","682","619","63","1344","71382","0.4557","40.4","1509","2997","2863","21","0","Stanley County, South Dakota","46","117"
"47","10","0","0","982","378","241","241","0","604","415","388","27","982","54583","0.4336","43.9","1607","2231","2002","33","29","Potter County, South Dakota","46","107"
"275","108","0","28","3166","1124","635","604","31","2042","1566","1483","83","3166","50481","0.4368","40.1","3910","9076","7317","30","2","Charles Mix County, South Dakota","46","023"
"136","89","10","13","1873","674","387","366","21","1199","934","863","71","1873","63723","0.3932","41.6","2637","4827","4327","12","102","Marshall County, South Dakota","46","091"
"85","44","0","24","1284","461","245","232","13","823","633","589","44","1284","57981","0.4452","42.3","1777","2854","2581","9","11","Perkins County, South Dakota","46","105"
"1799","903","95","20","12620","3605","2413","2269","144","9015","7277","6768","509","12620","39005","0.4975","37.8","15452","35504","33217","103","198","Whitley County, Kentucky","21","235"
"1123","612","6","34","15000","4660","2923","2807","116","10340","8120","7518","602","15000","32730","0.5145","38.9","18505","35979","34145","70","45","Floyd County, Kentucky","21","071"
"6800","5606","454","1801","63966","16284","9755","9214","541","47682","35063","31021","4042","63966","64339","0.4427","38.7","69661","164337","151706","1854","1572","Kenton County, Kentucky","21","117"
"487","104","13","17","5020","1449","889","885","4","3571","2685","2628","57","5020","28147","0.5039","40.0","6070","12362","11788","0","0","Magoffin County, Kentucky","21","153"
"2226","452","23","111","8623","2433","1420","1355","65","6190","4745","3738","1007","8623","38230","0.4943","36.0","10335","24270","22536","214","224","Rowan County, Kentucky","21","205"
"1956","372","87","0","9857","3186","1875","1802","73","6671","5373","4822","551","9857","44522","0.4764","38.7","11004","25165","23777","108","259","Taylor County, Kentucky","21","217"
"84","4","0","8","1980","719","415","353","62","1261","995","964","31","1980","45109","0.5426","39.4","2476","4725","4397","52","7","Carlisle County, Kentucky","21","039"
"1033","56","0","0","5499","1940","1157","1125","32","3559","2640","2474","166","5499","31688","0.4613","38.1","6927","14101","13180","0","2","Estill County, Kentucky","21","065"
"4234","2503","138","983","48488","14563","8634","8366","268","33925","26069","24169","1900","48488","47269","0.4839","40.2","58153","128068","112822","1583","992","Rapides Parish, Louisiana","22","079"
"6075","1490","167","177","47597","13105","8096","7954","142","34492","26379","23842","2537","47597","47832","0.4695","39.6","55325","131166","117216","893","493","Tangipahoa Parish, Louisiana","22","105"
"159","79","10","0","4084","1419","750","736","14","2665","2083","1957","126","4084","38500","0.4941","42.4","5158","10625","9025","115","25","West Carroll Parish, Louisiana","22","123"
"363","98","13","0","3665","1255","832","791","41","2410","1931","1743","188","3665","37691","0.5352","40.8","5208","9542","8259","52","2","Caldwell Parish, Louisiana","22","021"
"1506","152","16","0","2037","749","375","375","0","1288","924","818","106","2037","22346","0.7070","41.8","2889","4422","4007","4","14","East Carroll Parish, Louisiana","22","035"
"1382","197","262","90","12172","3556","1873","1820","53","8616","6307","5919","388","12172","31965","0.4904","40.7","15055","32001","28195","49","37","Evangeline Parish, Louisiana","22","039"
"1967","592","183","203","15005","3537","2405","2307","98","11468","8696","7957","739","15005","44661","0.4440","39.5","17035","45973","39252","922","669","St. Bernard Parish, Louisiana","22","087"
"1388","406","0","10","9643","2437","1779","1729","50","7206","5840","5465","375","9643","65385","0.4104","39.7","10977","25266","23118","49","25","West Baton Rouge Parish, Louisiana","22","121"
"317","10","13","0","3372","1100","565","563","2","2272","1537","1421","116","3372","33816","0.5533","39.5","4216","8413","7485","0","9","Red River Parish, Louisiana","22","081"
"1459","1295","84","78","14659","4293","2450","2410","40","10366","6431","5128","1303","14659","28567","0.5484","38.4","19133","38011","33303","378","114","Natchitoches Parish, Louisiana","22","069"
"938","47","8","0","3364","1124","615","615","0","2240","1838","1806","32","3364","40129","0.4891","43.8","5007","8488","7521","23","20","Catahoula Parish, Louisiana","22","025"
"617","72","0","48","7423","2496","1406","1389","17","4927","3897","3741","156","7423","35282","0.4937","42.0","9311","19057","17091","19","20","Franklin Parish, Louisiana","22","041"
"614","110","13","95","8552","2801","1743","1718","25","5751","4063","3766","297","8552","43759","0.4883","40.7","10805","22254","20284","15","83","Assumption Parish, Louisiana","22","007"
"1972","990","30","13","22086","6290","4121","3799","322","15796","12591","11344","1247","22086","51945","0.4430","43.6","26586","59363","52851","562","473","Vermilion Parish, Louisiana","22","113"
"983","374","218","6","7162","2544","1558","1546","12","4618","3223","3016","207","7162","32500","0.5062","40.5","9611","17764","15218","57","38","Concordia Parish, Louisiana","22","029"
"1829","1124","121","81","21338","7779","4920","4530","390","13559","10417","9476","941","21338","49204","0.4201","37.9","36942","57212","51413","442","344","Oxford County, Maine","23","017"
"4851","4325","448","301","62156","18942","11206","10266","940","43214","32468","27476","4992","62156","50808","0.4537","37.8","75789","150105","132865","2233","1775","Penobscot County, Maine","23","019"
"4052","2012","372","80","45630","13404","7901","7428","473","32226","24457","20605","3852","45630","53509","0.4267","38.4","49892","106432","94692","1733","1467","Androscoggin County, Maine","23","001"
"6916","8671","1141","2046","120644","36494","21553","19639","1914","84150","62824","52399","10425","120644","73072","0.4526","38.4","144470","288865","256151","9321","6727","Cumberland County, Maine","23","005"
"4180","7527","591","911","85314","28406","17929","16802","1127","56908","44033","38111","5922","85314","67830","0.4253","38.9","110226","202277","182643","3734","2377","York County, Maine","23","031"
"1988","788","118","12","21321","7553","4418","3960","458","13768","10984","9508","1476","21321","44256","0.4448","38.7","30868","49972","44488","461","341","Somerset County, Maine","23","025"
"1821","1051","115","587","22089","9792","6114","5784","330","12297","9290","8115","1175","22089","63499","0.4719","38.5","56310","51044","46643","1088","807","Worcester County, Maryland","24","047"
"1263","1335","139","299","16826","7096","4686","4417","269","9730","7314","6562","752","16826","73547","0.5161","39.7","20247","36739","33473","954","729","Talbot County, Maryland","24","041"
"4584","3655","965","1526","94323","44064","27321","25591","1730","50259","37815","33472","4343","94323","74336","0.4542","37.5","163557","211206","189245","9065","6017","Barnstable County, Massachusetts","25","001"
"1391","3296","496","844","54813","20461","11612","10754","858","34352","24528","21300","3228","54813","59230","0.4621","36.3","69079","124293","113694","4141","2678","Berkshire County, Massachusetts","25","003"
"15888","5468","2270","15428","187460","63145","40588","38186","2402","124315","100286","93457","6829","187460","89489","0.4539","37.8","207003","508430","451094","29303","16829","Plymouth County, Massachusetts","25","023"
"27925","14347","7553","53840","265300","82356","50645","48261","2384","182944","143753","127684","16069","265300","103291","0.4766","38.6","278615","692118","555742","74759","48976","Norfolk County, Massachusetts","25","021"
"380","206","86","45","3713","1171","733","670","63","2542","1860","1647","213","3713","107717","0.4936","38.9","12345","11114","9433","463","727","Nantucket County, Massachusetts","25","019"
"3946","773","201","132","43416","12558","8557","8049","508","30858","25419","23625","1794","43416","62965","0.4030","38.9","51177","115272","106968","1324","1779","Allegan County, Michigan","26","005"
"937","138","10","41","3007","1406","832","805","27","1601","1245","1135","110","3007","45570","0.4019","36.2","6691","8141","7411","30","27","Alger County, Michigan","26","003"
"1477","382","61","60","10156","3659","2450","2355","95","6497","5195","4896","299","10156","50104","0.4179","40.2","16157","26254","23157","202","541","Oceana County, Michigan","26","127"
"1794","538","33","81","12199","4859","2896","2792","104","7340","5579","5093","486","12199","39565","0.4536","37.5","23387","30319","26541","243","94","Clare County, Michigan","26","035"
"8004","1361","467","328","24739","5827","3540","3367","173","18912","14272","10647","3625","24739","45116","0.4905","34.9","29154","70160","62458","779","1061","Isabella County, Michigan","26","073"
"2329","507","48","45","21777","7205","4495","4230","265","14572","11622","10734","888","21777","49988","0.4122","38.9","24447","52230","49160","187","153","Tuscola County, Michigan","26","157"
"1005","187","95","101","12752","4471","2724","2594","130","8281","5876","5069","807","12752","43363","0.4390","37.7","16056","28172","26375","164","123","Alpena County, Michigan","26","007"
"2906","1399","532","335","34199","9964","6146","5911","235","24235","18878","17191","1687","34199","62625","0.4728","38.0","36973","82737","75996","1235","1912","Midland County, Michigan","26","111"
"373","73","8","3","3806","1626","968","872","96","2180","1608","1459","149","3806","42335","0.4439","38.1","9226","8202","7019","51","32","Oscoda County, Michigan","26","135"
"3931","1228","194","352","29728","8692","5591","5372","219","21036","16943","15379","1564","29728","70390","0.4193","38.0","31736","77840","72425","1114","1063","Clinton County, Michigan","26","037"
"2583","309","96","66","15035","4809","2738","2593","145","10226","8012","7300","712","15035","47848","0.4555","38.3","16330","36619","34600","216","164","Gratiot County, Michigan","26","057"
"4339","1419","255","150","38345","12167","7597","7284","313","26178","19462","17925","1537","38345","55450","0.4170","38.4","43806","95105","88009","850","839","Lenawee County, Michigan","26","091"
"3308","566","109","55","23913","7512","4816","4514","302","16401","13025","12020","1005","23913","49448","0.4178","38.6","28598","60929","55706","418","181","Montcalm County, Michigan","26","117"
"4864","1953","194","482","64850","20531","12821","12061","760","44319","33901","30808","3093","64850","56951","0.4342","38.9","72179","157967","146658","2268","1341","St. Clair County, Michigan","26","147"
"19786","14653","5932","9543","141245","34662","21387","20406","981","106583","77983","61050","16933","141245","72586","0.4848","36.7","151023","362262","306123","20369","23237","Washtenaw County, Michigan","26","161"
"1878","1624","146","18","21019","7308","4848","4664","184","13711","10778","9944","834","21019","55107","0.4544","39.6","26295","51401","47512","357","337","Cass County, Michigan","26","027"
"1404","439","47","73","11139","5247","3198","3061","137","5892","4151","3743","408","11139","42054","0.4295","38.5","24538","23640","21723","223","107","Roscommon County, Michigan","26","143"
"1525","860","145","68","16650","5365","3296","3129","167","11285","9002","8036","966","16650","51947","0.4143","39.7","20849","41346","35683","544","803","Branch County, Michigan","26","023"
"6899","2001","363","260","61805","19133","11796","11379","417","42672","31632","28872","2760","61805","53658","0.4452","38.3","69580","150711","139357","1422","1231","Jackson County, Michigan","26","075"
"28108","7266","3273","3194","346402","104263","62444","60081","2363","242139","182492","167167","15325","346402","62855","0.4246","39.0","366016","863583","732499","58617","27149","Macomb County, Michigan","26","099"
"534","111","2","2","3107","1170","758","740","18","1937","1360","1225","135","3107","46065","0.4566","38.2","5301","7302","6823","53","25","Baraga County, Michigan","26","013"
"7822","1066","620","441","44480","13765","8541","8157","384","30715","22975","20599","2376","44480","64348","0.4141","38.5","47558","108742","99453","1925","2089","Eaton County, Michigan","26","045"
"929","333","60","0","10154","3446","1858","1746","112","6708","4790","4354","436","10154","37640","0.4773","38.4","12155","25712","22325","187","154","Upson County, Georgia","13","293"
"1375","145","79","61","7503","2652","1657","1609","48","4851","3938","3706","232","7503","38068","0.4593","38.6","9332","18532","16277","84","82","Washington County, Georgia","13","303"
"1948","277","23","14","11695","4505","2947","2830","117","7190","6003","5751","252","11695","52493","0.4204","39.0","16254","29310","25482","420","166","White County, Georgia","13","311"
"1274","539","21","160","10136","3312","1981","1937","44","6824","5080","4659","421","10136","46636","0.4976","37.7","11652","27013","22460","535","546","Peach County, Georgia","13","225"
"8268","2341","156","289","53299","11982","8234","8039","195","41317","35315","33443","1872","53299","68370","0.3762","39.8","56654","158996","134214","3821","2630","Paulding County, Georgia","13","223"
"346","109","16","22","7048","2293","1625","1546","79","4755","3888","3773","115","7048","42804","0.4682","39.8","8167","19074","15835","84","138","Pierce County, Georgia","13","229"
"1131","93","19","13","6143","1955","1201","1185","16","4188","3465","3340","125","6143","64878","0.4197","39.1","6992","18073","15497","105","104","Pike County, Georgia","13","231"
"6872","8401","1172","1668","71400","19668","11205","10774","431","51732","36063","32571","3492","71400","42728","0.4738","39.3","88622","191532","160533","3597","2441","Richmond County, Georgia","13","245"
"651","117","27","1","5098","1793","1041","1007","34","3305","2561","2388","173","5098","39842","0.4607","41.4","6785","13591","11588","155","13","Screven County, Georgia","13","251"
"3771","357","29","8","8241","2576","1612","1578","34","5665","4563","4297","266","8241","40730","0.4543","40.2","10026","19039","15942","217","223","Tattnall County, Georgia","13","267"
"838","237","21","13","7367","2467","1464","1443","21","4900","3910","3612","298","7367","40415","0.4356","39.2","8798","18877","14278","128","191","Berrien County, Georgia","13","019"
"2029","313","50","49","11522","4036","2202","2118","84","7486","5849","5350","499","11522","52748","0.4378","39.4","13123","25894","24789","96","75","Montgomery County, Illinois","17","135"
"1489","835","146","113","23084","7872","4495","4264","231","15212","11717","10699","1018","23084","54232","0.4345","38.2","25823","55135","51131","656","753","Whiteside County, Illinois","17","195"
"876","1058","86","198","27112","8931","5194","5044","150","18181","13913","12562","1351","27112","52993","0.4503","39.4","30192","64844","60894","608","268","Adams County, Illinois","17","001"
"1256","448","93","196","14353","4396","2402","2270","132","9957","8065","7313","752","14353","66639","0.4101","38.8","15882","35508","33666","252","252","Clinton County, Illinois","17","027"
"8027","1848","568","684","38150","8598","5437","5210","227","29552","22305","17954","4351","38150","63317","0.4361","37.0","41206","103654","92576","2421","3192","DeKalb County, Illinois","17","037"
"296","80","9","0","2773","939","539","522","17","1834","1403","1281","122","2773","51080","0.4144","39.7","3201","6428","6001","12","14","Edwards County, Illinois","17","047"
"263","12","29","0","3711","1222","710","699","11","2489","1895","1724","171","3711","54256","0.4192","39.3","4349","9532","8863","8","31","Jasper County, Illinois","17","079"
"1489","555","114","119","14985","4640","2792","2652","140","10345","7658","7158","500","14985","49896","0.4516","38.6","16998","35639","32948","379","210","Jefferson County, Illinois","17","081"
"1516","693","128","219","31151","10477","5885","5569","316","20674","15108","13846","1262","31151","46515","0.4506","38.5","36109","74983","69432","710","544","Vermilion County, Illinois","17","183"
"26046","5742","1862","13360","229498","59610","40381","38815","1566","169888","140362","132412","7950","229498","86961","0.4068","38.5","243907","682082","578037","44136","25692","Will County, Illinois","17","197"
"2676","844","78","146","27029","8910","4924","4795","129","18119","13472","12158","1314","27029","50734","0.4509","38.4","31286","65070","60738","416","471","Williamson County, Illinois","17","199"
"532","237","19","15","6720","2056","1276","1246","30","4664","3916","3574","342","6720","56531","0.4221","38.8","7814","15505","14605","43","135","Clark County, Illinois","17","023"
"634","167","29","0","7613","2337","1368","1273","95","5276","4161","3788","373","7613","56714","0.4240","38.8","8446","19464","16151","257","204","Douglas County, Illinois","17","041"
"1252","504","170","79","13877","4078","2377","2226","151","9799","7478","6951","527","13877","56685","0.4544","38.7","14892","33733","31542","256","366","Effingham County, Illinois","17","049"
"1546","394","27","17","13940","4914","2889","2775","114","9026","6667","6053","614","13940","51643","0.4538","38.4","16328","32562","30383","91","71","Fulton County, Illinois","17","057"
"594","141","4","7","4949","1724","958","938","20","3225","2510","2334","176","4949","49885","0.4204","37.2","6438","12849","12035","22","34","Greene County, Illinois","17","061"
"160","37","0","53","3400","1231","701","617","84","2169","1873","1747","126","3400","54046","0.4165","40.1","4107","8100","7609","38","16","Hamilton County, Illinois","17","065"
"117","49","0","38","1363","579","401","388","13","784","566","541","25","1363","51250","0.5011","39.8","2181","3841","3519","10","0","Hardin County, Illinois","17","069"
"1055","634","67","16","19856","6834","3910","3810","100","13022","10271","9664","607","19856","59933","0.4151","38.6","22165","48549","45500","382","465","Henry County, Illinois","17","073"
"1533","63","9","0","4303","1842","1199","1147","52","2461","2019","1895","124","4303","52774","0.4409","38.9","5625","10217","9754","44","10","Johnson County, Illinois","17","087"
"1683","305","137","91","20680","7548","3789","3497","292","13132","9376","8298","1078","20680","44129","0.4523","36.9","23917","47703","44033","287","1010","Knox County, Illinois","17","095"
"1442","211","41","30","14307","4730","2741","2647","94","9577","7319","6799","520","14307","55160","0.4302","38.9","15919","33887","31757","223","333","Livingston County, Illinois","17","105"
"146","25","0","8","1939","716","444","429","15","1223","991","954","37","1939","57118","0.3907","38.1","2450","4953","4774","24","22","Scott County, Illinois","17","171"
"4817","1562","293","407","54291","16689","9892","9577","315","37602","28757","26559","2198","54291","63454","0.4181","38.3","58847","130814","123818","1008","1012","Tazewell County, Illinois","17","179"
"712","437","46","56","6862","2254","1326","1280","46","4608","3524","3278","246","6862","50310","0.4120","37.5","7687","16952","15403","298","577","Warren County, Illinois","17","187"
"1310","469","160","18","14403","4538","2913","2750","163","9865","7938","7283","655","14403","57712","0.4253","38.6","17078","39616","36596","231","219","Harrison County, Indiana","18","061"
"5279","2570","77","515","43039","13954","8137","7713","424","29085","22511","20299","2212","43039","53658","0.4402","38.9","49177","102327","91814","1898","707","LaPorte County, Indiana","18","091"
"1347","575","81","100","12862","4232","2562","2476","86","8630","6647","6015","632","12862","54259","0.4019","38.1","14154","30377","27515","250","173","Wabash County, Indiana","18","169"
"1218","739","12","57","12533","3967","2592","2531","61","8566","6744","6210","534","12533","63892","0.3774","39.1","13554","33106","30360","328","245","Jasper County, Indiana","18","073"
"293","163","12","0","4187","1396","713","679","34","2791","2096","1834","262","4187","52726","0.4032","39.8","4814","9926","9257","14","6","Martin County, Indiana","18","101"
"5395","4730","355","892","64517","18452","12115","11635","480","46065","36049","32371","3678","64517","71152","0.4267","39.2","68720","166977","151997","3467","1745","Porter County, Indiana","18","127"
"975","311","89","46","10992","3406","1889","1765","124","7586","6054","5721","333","10992","56332","0.4280","38.9","12355","27900","25363","191","61","Ripley County, Indiana","18","137"
"480","303","7","13","8127","2694","1700","1628","72","5433","4297","4053","244","8127","57305","0.4418","39.6","9095","20213","19098","147","121","Spencer County, Indiana","18","147"
"891","117","50","48","6376","2117","1253","1218","35","4259","3529","3130","399","6376","58118","0.4001","39.8","7011","14957","13669","63","129","Tipton County, Indiana","18","159"
"5850","2760","511","399","41994","11989","6622","6207","415","30005","21772","18484","3288","41994","45230","0.4676","37.2","47215","103552","93337","982","1540","Vigo County, Indiana","18","167"
"2535","1522","91","102","24514","7121","4724","4587","137","17393","14306","13244","1062","24514","73482","0.4409","40.2","25961","61555","56783","1122","769","Warrick County, Indiana","18","173"
"1656","480","47","4","16801","4811","2968","2866","102","11990","9258","8686","572","16801","56421","0.4258","39.7","18045","42603","38762","296","214","DeKalb County, Indiana","18","033"
"1011","1027","110","34","12325","3471","2435","2358","77","8854","7667","7172","495","12325","64498","0.3998","38.2","14790","39040","22688","121","261","LaGrange County, Indiana","18","087"
"679","69","10","13","6667","2084","1224","1169","55","4583","3825","3542","283","6667","54346","0.4060","41.4","7482","16452","14763","37","45","Rush County, Indiana","18","139"
"4150","1541","206","49","25485","5832","3717","3546","171","19653","16133","14968","1165","25485","83077","0.4894","40.2","27050","64836","59191","1185","1518","Boone County, Indiana","18","011"
"492","274","21","39","6744","2649","1380","1296","84","4095","2616","2312","304","6744","38839","0.4887","37.2","10781","13916","12687","99","54","Gogebic County, Michigan","26","053"
"1098","146","161","43","9209","3017","1814","1715","99","6192","4843","4489","354","9209","63452","0.4215","39.4","10880","22788","21441","131","166","Meeker County, Minnesota","27","093"
"3816","1659","481","101","23005","6886","4008","3872","136","16119","12694","11548","1146","23005","68584","0.4333","35.7","25014","63601","56655","1476","2435","Rice County, Minnesota","27","131"
"116","18","0","1","1669","534","323","307","16","1135","863","805","58","1669","58576","0.4109","39.8","1938","3997","3819","25","10","Red Lake County, Minnesota","27","125"
"2242","3576","232","262","24364","5580","3094","3007","87","18784","14192","12405","1787","24364","65269","0.4202","37.5","26456","62943","57629","1441","1278","Clay County, Minnesota","27","027"
"516","260","73","203","8616","2775","1738","1672","66","5841","4591","4207","384","8616","61207","0.4060","39.6","9965","20577","18462","102","127","Fillmore County, Minnesota","27","045"
"830","1122","39","98","12584","3781","1997","1883","114","8803","6349","5914","435","12584","59343","0.4239","39.0","14952","30934","28821","573","520","Polk County, Minnesota","27","119"
"633","150","29","28","6031","1855","1122","1064","58","4176","3262","3032","230","6031","63439","0.4089","40.3","6602","14772","13642","173","251","Sibley County, Minnesota","27","143"
"308","39","28","60","4310","1508","822","808","14","2802","2220","2058","162","4310","54065","0.4279","39.6","5056","10843","8741","327","511","Watonwan County, Minnesota","27","165"
"224","97","3","19","2298","884","439","423","16","1414","1122","983","139","2298","53900","0.4234","38.9","3152","4862","4609","10","11","Big Stone County, Minnesota","27","011"
"1546","286","41","86","13164","5060","3387","3219","168","8104","6112","5542","570","13164","52204","0.4365","38.9","25866","28995","26564","205","82","Cass County, Minnesota","27","021"
"1012","440","54","55","8688","3457","2369","2302","67","5231","4042","3683","359","8688","56709","0.4229","39.0","14817","20867","19487","121","68","Hubbard County, Minnesota","27","057"
"518","577","78","40","8759","3074","1684","1574","110","5685","4277","3939","338","8759","52798","0.4342","39.9","9981","19660","18318","182","40","Martin County, Minnesota","27","091"
"310","281","103","37","8033","2325","1416","1377","39","5708","4439","4185","254","8033","55304","0.4162","39.8","8659","21429","16423","1407","1811","Nobles County, Minnesota","27","105"
"6878","863","336","902","32206","6991","4659","4389","270","25215","21863","19798","2065","32206","89250","0.3661","39.2","33934","92421","87193","1799","961","Sherburne County, Minnesota","27","141"
"5371","1191","224","1192","36754","8076","5207","5055","152","28678","24147","22511","1636","36754","101496","0.4238","38.9","38271","101658","94259","2915","1459","Carver County, Minnesota","27","019"
"1403","318","47","80","14714","4593","2734","2566","168","10121","7733","6917","816","14714","62121","0.4132","38.9","15890","35599","33177","425","307","McLeod County, Minnesota","27","085"
"30494","13069","4515","18623","209043","55383","30231","28339","1892","153660","109798","93923","15875","209043","64660","0.4600","37.2","219977","540315","436185","43118","32601","Ramsey County, Minnesota","27","123"
"2299","1923","250","526","19442","5571","3414","3297","117","13871","9944","8033","1911","19442","59329","0.4341","36.7","21220","50270","45865","481","992","Winona County, Minnesota","27","169"
"1056","198","39","174","7756","1960","1259","1230","29","5796","4740","4448","292","7756","74575","0.3864","40.1","8241","20574","19191","181","305","Dodge County, Minnesota","27","039"
"2449","1089","74","83","26820","9442","6077","5749","328","17378","13223","11835","1388","26820","56549","0.4562","38.5","41916","63444","59816","549","132","Crow Wing County, Minnesota","27","035"
"5411","1337","226","602","48242","11046","7204","6872","332","37196","31194","28809","2385","48242","84974","0.3881","38.9","51815","133647","125690","2104","1318","Wright County, Minnesota","27","171"
"233","162","7","11","2468","905","497","477","20","1563","1117","1026","91","2468","53077","0.4492","40.9","3135","5512","5203","21","19","Lincoln County, Minnesota","27","081"
"1671","170","54","152","10249","3239","1882","1754","128","7010","5308","4861","447","10249","56135","0.4215","38.5","12914","25419","23631","168","130","Mille Lacs County, Minnesota","27","095"
"1604","314","56","46","13613","4105","2582","2438","144","9508","7533","6800","733","13613","63098","0.4024","37.5","16062","34304","32527","214","143","Carlton County, Minnesota","27","017"
"744","100","18","45","6439","2235","1504","1383","121","4204","3300","2975","325","6439","57163","0.3918","38.3","7931","15915","14898","105","17","Kanabec County, Minnesota","27","065"
"4115","867","32","87","32036","10052","7136","6948","188","21984","17157","16452","705","32036","58308","0.4065","40.3","36714","85980","77841","582","276","St. Clair County, Alabama","01","115"
"2602","889","31","22","31034","10370","6205","6040","165","20664","16524","15534","990","31034","44918","0.4416","39.4","37842","81979","71400","598","889","Cullman County, Alabama","01","043"
"1861","2632","252","19","39311","12339","7561","7349","212","26972","19779","18398","1381","39311","47580","0.4832","38.9","47457","103775","91273","1023","576","Houston County, Alabama","01","069"
"7743","8502","742","497","72461","18419","11710","11359","351","54042","40126","35608","4518","72461","53326","0.4677","37.4","90557","205775","185237","2151","3473","Tuscaloosa County, Alabama","01","125"
"2517","2256","327","4","19924","5977","3666","3596","70","13947","10805","10151","654","19924","55637","0.4327","39.9","23188","50029","43668","829","650","Coffee County, Alabama","01","031"
"1304","201","64","0","16927","5030","2873","2812","61","11897","9719","9096","623","16927","47468","0.4719","39.9","19781","43726","36944","449","652","Chilton County, Alabama","01","021"
"549","125","18","0","4032","1577","957","935","22","2455","1781","1722","59","4032","38990","0.4515","40.1","6585","10348","9469","4","49","Coosa County, Alabama","01","037"
"3156","1455","192","37","38942","13420","7788","7514","274","25522","19526","18338","1188","38942","44637","0.4594","39.5","47704","101958","89271","945","961","Etowah County, Alabama","01","055"
"303","177","19","35","5856","2290","1331","1271","60","3566","2695","2624","71","5856","38364","0.4720","40.4","7403","13720","12216","25","25","Lamar County, Alabama","01","075"
"345","135","12","12","6506","2232","1412","1376","36","4274","3096","2955","141","6506","40688","0.4619","39.5","10089","19538","17698","71","75","Butler County, Alabama","01","013"
"2775","691","48","28","25019","8774","5467","5255","212","16245","12900","11911","989","25019","43629","0.4522","39.4","31141","63390","55478","351","112","Walker County, Alabama","01","127"
"27","12","31","0","2951","1342","609","572","37","1609","1009","970","39","2951","24145","0.5115","38.3","5112","8269","7189","16","7","Greene County, Alabama","01","063"
"185","36","11","0","3521","1120","713","674","39","2401","1899","1830","69","3521","37785","0.4731","41.1","4557","9865","8678","65","0","Bullock County, Alabama","01","011"
"772","603","83","36","13448","4652","2909","2834","75","8796","6433","5719","714","13448","42289","0.4230","39.8","16988","33252","29274","125","424","Chambers County, Alabama","01","017"
"104","21","0","2","1007","493","267","206","61","514","452","414","38","1007","58059","0.3985","44.5","1691","2513","2059","83","35","Haines Borough, Alaska","02","100"
"634","1463","307","747","12676","2909","1804","1638","166","9767","7182","6135","1047","12676","88390","0.3985","40.6","13698","31496","26100","1372","715","Juneau City and Borough, Alaska","02","110"
"217","77","16","11","1856","544","316","284","32","1312","891","800","91","1856","41413","0.4671","40.3","4090","5346","3845","33","21","Yukon-Koyukuk Census Area, Alaska","02","290"
"154","480","121","10","613","163","84","84","0","450","291","237","54","613","81719","0.3486","42.5","1533","2188","1639","44","101","Denali Borough, Alaska","02","068"
"109","94","0","25","791","305","219","208","11","486","308","270","38","791","59803","0.4306","45.4","1643","2136","1535","31","42","Hoonah-Angoon Census Area, Alaska","02","105"
"66","66","8","3","1027","404","255","251","4","623","447","403","44","1027","53894","0.4208","45.8","1512","2482","1950","12","53","Wrangell City and Borough, Alaska","02","275"
"18429","38805","9036","10109","404739","137560","87362","81519","5843","267179","193810","167294","26516","404739","53379","0.4694","37.6","459912","1005471","811029","58712","43319","Pima County, Arizona","04","019"
"2673","1531","176","30","21945","10689","6932","6321","611","11256","8321","7791","530","21945","43524","0.4427","38.5","33542","52797","46011","903","609","Gila County, Arizona","04","007"
"4473","6211","1156","311","50163","19976","12273","11277","996","30187","22825","21185","1640","50163","49260","0.4427","38.8","61108","116349","97248","6485","3578","Cochise County, Arizona","04","003"
"1482","634","73","190","20867","7458","4867","4741","126","13409","9458","9075","383","20867","32508","0.5013","38.4","32891","70867","52425","471","189","Apache County, Arizona","04","001"
"2912","8251","3390","1542","73098","26284","18118","17017","1101","46814","39621","37029","2592","73098","45243","0.4429","40.1","92625","202580","132933","21117","22788","Yuma County, Arizona","04","027"
"5354","1941","275","442","34990","13125","8925","8432","493","21865","16971","15923","1048","34990","40067","0.4739","37.7","58011","106822","90663","1221","869","Navajo County, Arizona","04","017"
"286","288","7","0","6444","2339","1210","1171","39","4105","3182","2969","213","6444","37233","0.4663","40.1","8038","14771","13694","79","40","Clay County, Arkansas","05","021"
"693","396","25","0","7157","2199","1369","1299","70","4958","3854","3352","502","7157","46997","0.4941","37.8","8655","18000","16863","66","78","Drew County, Arkansas","05","043"
"807","330","9","2","7355","2484","1522","1462","60","4871","3646","3532","114","7355","37218","0.4756","40.5","8609","17391","15939","105","84","Randolph County, Arkansas","05","121"
"1289","1049","25","13","15034","5045","3168","3104","64","9989","7885","7351","534","15034","45374","0.4364","40.1","17020","36902","34038","216","86","Boone County, Arkansas","05","009"
"996","198","7","6","3773","1339","891","866","25","2434","1984","1845","139","3773","46596","0.4604","39.6","4932","8363","7662","37","41","Lincoln County, Arkansas","05","079"
"993","1077","107","51","19074","4958","2924","2786","138","14116","10303","9178","1125","19074","40161","0.4689","40.5","21798","48179","43588","154","411","Crittenden County, Arkansas","05","035"
"5340","1858","294","88","44575","10291","6419","6268","151","34284","26042","22574","3468","44575","52827","0.4674","38.9","49842","122146","109029","1141","1245","Faulkner County, Arkansas","05","045"
"2787","1942","67","37","25975","8922","5487","5266","221","17053","13981","13148","833","25975","46157","0.4500","39.1","30353","67530","58415","387","431","Walker County, Georgia","13","295"
"27852","25861","6904","4897","293330","60194","43891","42591","1300","233136","191184","179506","11678","293330","71026","0.4267","39.4","309166","910143","605890","92205","61630","Gwinnett County, Georgia","13","135"
"3911","1480","228","96","26305","6882","4540","4352","188","19423","16288","15528","760","26305","62345","0.3931","39.6","28423","78857","63355","2496","1620","Barrow County, Georgia","13","013"
"298","414","156","22","3675","1178","841","805","36","2497","2015","1880","135","3675","41961","0.4222","39.0","4524","11859","9426","46","16","Charlton County, Georgia","13","049"
"191","0","20","0","2477","769","497","443","54","1708","1292","1196","96","2477","27658","0.5192","40.2","3016","6597","5208","56","50","Clinch County, Georgia","13","065"
"5237","941","214","351","37627","10331","7135","6760","375","27296","22130","20660","1470","37627","57423","0.4388","40.2","41072","103876","85243","1459","1722","Bartow County, Georgia","13","015"
"8556","2752","458","550","49187","11462","7994","7618","376","37725","29610","27199","2411","49187","63835","0.4100","39.7","52686","142126","114496","5890","3355","Douglas County, Georgia","13","097"
"905","396","10","0","9136","3122","1775","1751","24","6014","4918","4569","349","9136","43531","0.4599","40.1","10869","24639","19758","96","166","Grady County, Georgia","13","131"
"861","86","8","6","2974","1292","728","669","59","1682","1127","1086","41","2974","31860","0.4697","40.8","5391","6054","5375","12","9","Hancock County, Georgia","13","141"
"2141","1747","154","28","35629","9809","6266","5963","303","25820","21026","19756","1270","35629","48623","0.4585","38.8","40039","103393","73727","4567","7906","Whitfield County, Georgia","13","313"
"952","55","0","0","4696","1500","851","841","10","3196","2256","2192","64","4696","32161","0.4998","39.3","6104","11267","9048","78","34","Macon County, Georgia","13","193"
"2475","1301","345","18","24928","7188","4421","4348","73","17740","13291","12599","692","24928","45649","0.4715","40.0","28529","68479","58295","872","1203","Troup County, Georgia","13","285"
"1617","768","55","71","12156","4193","3004","2980","24","7963","6813","6601","212","12156","76319","0.4436","39.9","14168","33448","30533","453","187","Harris County, Georgia","13","145"
"308","0","4","0","1864","579","358","358","0","1285","1097","1094","3","1864","44448","0.4440","38.8","2206","5221","4416","25","37","Schley County, Georgia","13","249"
"389","221","0","1","8002","2607","1794","1747","47","5395","4485","4149","336","8002","45398","0.4566","39.3","9336","20332","16341","207","37","Worth County, Georgia","13","321"
"1092","84","40","58","5020","1808","1027","1013","14","3212","2525","2337","188","5020","37340","0.4815","39.8","6260","12384","10227","82","8","Dooly County, Georgia","13","093"
"750","110","0","14","4020","1298","779","688","91","2722","2194","2059","135","4020","42607","0.4574","39.9","4749","10153","8282","102","51","Evans County, Georgia","13","109"
"92","59","0","0","1140","392","224","210","14","748","552","514","38","1140","37297","0.4952","41.1","1480","2606","2297","80","16","Webster County, Georgia","13","307"
"2569","1071","82","40","21172","4847","3124","3056","68","16325","13142","12368","774","21172","66822","0.4409","40.7","22745","59827","52926","866","714","Effingham County, Georgia","13","103"
"82","26","0","0","1108","330","192","189","3","778","578","537","41","1108","45000","0.4538","40.0","1526","2915","2700","0","4","Glascock County, Georgia","13","125"
"37","178","0","0","842","419","276","267","9","423","321","310","11","842","26667","0.4874","41.5","1956","2289","1721","14","14","Quitman County, Georgia","13","239"
"11285","14635","2440","3435","108568","30389","18408","17517","891","78179","57431","49568","7863","108568","56842","0.4869","39.0","125272","280698","228017","6375","6407","Chatham County, Georgia","13","051"
"481","235","43","0","3393","1192","711","694","17","2201","1543","1514","29","3393","42446","0.4208","41.5","4116","9081","7756","65","0","Johnson County, Georgia","13","167"
"962","241","63","1","3714","1022","610","610","0","2692","2012","1926","86","3714","40986","0.4687","41.0","4419","9700","8159","91","35","Lanier County, Georgia","13","173"
"1802","307","18","23","10744","3448","2394","2325","69","7296","6106","5828","278","10744","52500","0.4205","38.8","12004","29006","24258","247","119","Madison County, Georgia","13","195"
"1122","171","32","32","7982","2718","1524","1463","61","5264","4292","3991","301","7982","38116","0.4683","39.8","9065","19990","16481","36","37","Mitchell County, Georgia","13","205"
"1378","316","82","52","15144","4262","2746","2638","108","10882","8659","8065","594","15144","45639","0.4571","38.1","16745","40057","31253","404","880","Tift County, Georgia","13","277"
"1669","619","118","51","15038","4848","2881","2776","105","10190","8250","7375","875","15038","44891","0.4768","39.9","17023","41735","33734","731","717","Polk County, Georgia","13","233"
"277","40","0","7","2809","1188","791","770","21","1621","1177","1079","98","2809","38549","0.4411","40.8","3425","6302","5303","56","0","Talbot County, Georgia","13","263"
"435","45","10","18","3399","1250","766","745","21","2149","1728","1603","125","3399","34768","0.4709","38.3","4165","8379","6847","15","117","Terrell County, Georgia","13","273"
"2165","1665","55","39","17595","5473","3645","3498","147","12122","9221","8663","558","17595","43740","0.5001","40.0","20715","44003","36814","201","429","Thomas County, Georgia","13","275"
"309","29","0","9","3185","1101","664","610","54","2084","1568","1469","99","3185","38996","0.4838","39.9","4488","8925","8025","12","17","Wilkinson County, Georgia","13","319"
"572","120","21","0","5651","2038","1182","1111","71","3613","2681","2600","81","5651","47120","0.4158","39.9","6660","14802","12927","15","56","Oglethorpe County, Georgia","13","221"
"217","55","4","18","2553","1049","686","667","19","1504","1099","944","155","2553","31699","0.4500","39.5","3688","6863","5939","8","0","Randolph County, Georgia","13","243"
"1516","710","0","68","13823","4267","2817","2694","123","9556","6569","6215","354","13823","36869","0.4652","40.1","16718","33195","27391","143","248","Ware County, Georgia","13","299"
"651","754","58","67","10400","3078","2035","1960","75","7322","5672","5206","466","10400","45483","0.4345","37.8","12287","27735","23173","143","243","Wayne County, Georgia","13","305"
"632","43","1","10","2575","932","618","606","12","1643","1272","1201","71","2575","36964","0.4679","40.3","3522","6746","5577","14","11","Wilcox County, Georgia","13","315"
"3410","475","48","121","16191","4625","2792","2671","121","11566","8334","6897","1437","16191","43672","0.4639","37.2","20588","43432","37346","479","445","Baldwin County, Georgia","13","009"
"8691","1519","200","384","27375","6422","3941","3840","101","20953","16146","12813","3333","27375","45550","0.4689","36.8","31135","75305","63675","807","783","Bulloch County, Georgia","13","031"
"20","53","0","0","1242","534","277","272","5","708","478","436","42","1242","22325","0.4824","38.5","2073","2898","2407","28","0","Clay County, Georgia","13","061"
"138","71","0","5","1561","443","290","275","15","1118","835","822","13","1561","39494","0.5002","39.9","1871","3981","3005","23","19","Echols County, Georgia","13","101"
"34777","22564","7562","27720","282436","64159","38796","36574","2222","218277","147431","126942","20489","282436","62399","0.4894","39.4","311880","743368","558778","43135","37552","DeKalb County, Georgia","13","089"
"1351","813","49","0","11259","3381","2166","2094","72","7878","6309","5866","443","11259","48550","0.4394","40.4","12466","28880","25136","86","100","Haralson County, Georgia","13","143"
"787","112","10","3","5664","1913","1117","1077","40","3751","2806","2521","285","5664","33944","0.4730","39.9","7283","15164","12750","115","57","Jefferson County, Georgia","13","163"
"295","94","0","9","3475","1389","749","724","25","2086","1568","1418","150","3475","39742","0.4995","39.0","4890","7769","6749","25","29","Lincoln County, Georgia","13","181"
"914","224","18","26","14385","4248","2720","2585","135","10137","8636","7972","664","14385","48033","0.4096","39.4","16114","39495","31660","626","1458","Murray County, Georgia","13","213"
"525","219","16","1","3687","1477","979","949","30","2210","1664","1530","134","3687","45148","0.4460","39.2","4504","9676","8205","86","2","Pulaski County, Georgia","13","235"
"351","283","49","33","6662","3045","2078","1885","193","3617","2533","2335","198","6662","42500","0.5086","37.9","12630","16407","13133","148","274","Rabun County, Georgia","13","241"
"525","336","55","9","4898","2592","1739","1661","78","2306","1824","1579","245","4898","48219","0.4437","35.9","8229","11440","9866","159","58","Towns County, Georgia","13","281"
"624","42","13","0","2490","921","520","520","0","1569","1158","1134","24","2490","32241","0.5255","39.2","3205","6454","5136","4","8","Treutlen County, Georgia","13","283"
"395","90","22","0","3329","1224","650","641","9","2105","1483","1449","34","3329","37736","0.4814","37.8","4066","9190","7404","62","29","Irwin County, Georgia","13","155"
"428","63","8","22","6656","2122","1412","1355","57","4534","3634","3520","114","6656","40304","0.4586","39.5","8567","17976","14775","229","212","Appling County, Georgia","13","001"
"1173","291","46","21","18608","5330","3243","3154","89","13278","10584","9836","748","18608","63806","0.3917","39.4","20448","48410","45619","414","343","Shelby County, Ohio","39","149"
"1270","708","0","158","15090","4755","2555","2486","69","10335","7870","7100","770","15090","53183","0.3983","39.3","16644","35749","33672","204","158","Williams County, Ohio","39","171"
"2086","1609","151","145","41537","14314","8709","8240","469","27223","20578","19090","1488","41537","48345","0.4403","38.6","46829","99556","92484","531","122","Columbiana County, Ohio","39","029"
"1381","298","65","72","16506","4921","3233","3119","114","11585","9320","8622","698","16506","63092","0.3908","39.4","17560","41843","39239","351","212","Fulton County, Ohio","39","051"
"891","560","12","20","11588","3789","2195","2113","82","7799","5994","5450","544","11588","44858","0.4487","38.1","13896","29701","26489","145","187","Gallia County, Ohio","39","053"
"6068","3820","603","1184","98472","33621","18812","18010","802","64851","45649","41543","4106","98472","46042","0.4740","37.8","111361","225662","210488","3201","1349","Mahoning County, Ohio","39","099"
"2607","1228","85","59","29858","9544","5682","5389","293","20314","15393","14083","1310","29858","41330","0.4891","37.8","34563","73255","68686","309","219","Scioto County, Ohio","39","145"
"1396","405","30","138","12922","3989","2687","2564","123","8933","7429","6921","508","12922","59452","0.4039","40.1","14299","34810","32174","136","51","Morrow County, Ohio","39","117"
"896","573","105","18","6782","3051","2006","1862","144","3731","2758","2576","182","6782","36719","0.4416","39.8","9490","16356","15110","152","158","Marion County, Arkansas","05","089"
"166","149","45","19","3327","1374","960","899","61","1953","1488","1434","54","3327","36438","0.4554","37.7","4936","7823","7268","20","29","Searcy County, Arkansas","05","129"
"5325","9475","1350","162","97249","24022","15940","15290","650","73227","59808","55096","4712","97249","66362","0.4586","41.1","105634","264163","217902","8614","14063","Benton County, Arkansas","05","007"
"2028","511","21","26","12599","4223","2701","2607","94","8376","6635","6250","385","12599","43889","0.4280","39.2","14512","31424","28972","120","90","Hot Spring County, Arkansas","05","059"
"596","197","9","0","6279","2087","1347","1263","84","4192","3193","3055","138","6279","41682","0.4771","40.1","7581","16133","13985","275","204","Madison County, Arkansas","05","087"
"36","104","4","6","759","357","207","207","0","402","309","284","25","759","45972","0.4306","43.6","1581","1857","1737","8","14","Dolores County, Colorado","08","033"
"88","2","0","0","558","243","161","146","15","315","268","236","32","558","53300","0.3906","42.1","1319","1256","1112","45","22","Jackson County, Colorado","08","057"
"515","842","43","5","10655","3761","2427","2224","203","6894","5339","4834","505","10655","49470","0.4162","39.3","12331","25856","22231","254","234","Montezuma County, Colorado","08","083"
"15510","19732","3146","8423","127415","31410","18783","17265","1518","96005","72004","56548","15456","127415","83019","0.4848","36.8","136096","320329","275894","13961","15593","Boulder County, Colorado","08","013"
"380","196","362","3","4028","1292","784","752","32","2736","2248","2079","169","4028","52022","0.4235","40.7","4556","9866","8233","48","695","Yuma County, Colorado","08","125"
"1188","928","69","358","9603","2438","1604","1535","69","7165","5465","4452","1013","9603","77443","0.4632","37.6","16828","24935","22115","556","452","Routt County, Colorado","08","107"
"858","388","24","28","4395","1368","766","736","30","3027","2089","1819","270","4395","67060","0.4205","38.4","5793","9382","8261","70","121","Clear Creek County, Colorado","08","019"
"5015","4119","331","489","64314","21126","12960","12216","744","43188","32075","28755","3320","64314","46783","0.4547","37.9","71223","162675","148304","1934","1604","Pueblo County, Colorado","08","101"
"1179","540","12","73","6931","2235","1741","1665","76","4696","3520","3106","414","6931","73622","0.3978","40.0","14554","17738","15779","244","142","Park County, Colorado","08","093"
"5504","5277","274","226","61742","20050","12179","11547","632","41692","31755","27618","4137","61742","55379","0.4419","38.7","66599","150129","131519","2596","1467","Mesa County, Colorado","08","077"
"16273","49457","6574","2476","257507","61830","39300","37502","1798","195677","153622","138050","15572","257507","68779","0.4322","39.3","272379","667275","582042","23608","13715","El Paso County, Colorado","08","041"
"39208","21814","5057","14201","240304","57824","36314","34848","1466","182480","138967","122764","16203","240304","77469","0.4522","39.4","251212","637690","513146","39975","35528","Arapahoe County, Colorado","08","005"
"4106","21338","3018","10209","205829","58242","36819","34812","2007","147587","109655","97402","12253","205829","73892","0.4584","38.5","223259","547702","465034","29317","26516","New Castle County, Delaware","10","003"
"4222","6846","579","862","65796","20455","13746","12975","771","45341","35564","32163","3401","65796","60910","0.4279","38.4","71753","173035","152263","5241","3234","Kent County, Delaware","10","001"
"4615","3209","254","1345","74143","25871","16095","14991","1104","48272","37015","33480","3535","74143","79906","0.4566","38.6","88252","180743","160798","7850","5102","Litchfield County, Connecticut","09","005"
"34177","37930","17146","10967","554095","230883","137734","127643","10091","323212","244519","217655","26864","554095","63299","0.5219","38.7","686410","1451973","988718","175767","98208","Palm Beach County, Florida","12","099"
"26899","24932","49286","60693","883372","286486","199108","188645","10463","596886","457352","417803","39549","883372","51347","0.5231","38.6","1024194","2675253","1093415","733996","398605","Miami-Dade County, Florida","12","086"
"1070","276","11","21","4444","1871","1170","1120","50","2573","1809","1609","200","4444","46643","0.5056","38.4","8725","10226","8197","98","58","Franklin County, Florida","12","037"
"1692","74","1","9","4381","1624","1166","1067","99","2757","2148","2015","133","4381","38569","0.4683","38.7","5827","11031","9317","60","142","Hamilton County, Florida","12","047"
"3890","5598","791","39","56230","43398","30463","29024","1439","12832","8921","8185","736","56230","57226","0.4354","36.5","70800","115706","104208","3684","1305","Sumter County, Florida","12","119"
"1703","447","0","18","7092","2825","1750","1679","71","4267","3314","3100","214","7092","39102","0.4525","38.9","8711","17634","14417","59","36","Holmes County, Florida","12","059"
"14067","28376","6080","2030","275965","128973","86576","80600","5976","146992","111987","101158","10829","275965","57832","0.4798","38.6","394047","732479","547294","51981","35624","Lee County, Florida","12","071"
"8152","15617","4991","2415","142979","72784","50117","47237","2880","70195","54949","50318","4631","142979","69653","0.5257","38.9","214473","369593","250362","35836","26651","Collier County, Florida","12","021"
"21915","15064","2574","929","204198","79646","50384","46829","3555","124552","97376","88438","8938","204198","52828","0.4517","39.2","243451","518687","417321","27768","14064","Pasco County, Florida","12","101"
"3158","3070","1236","349","41740","23257","15528","14313","1215","18483","13735","12752","983","41740","40942","0.4855","38.4","55791","102275","82592","4633","3709","Highlands County, Florida","12","055"
"1918","563","520","595","12072","4876","3302","3062","240","7196","5597","5201","396","12072","35438","0.4404","40.8","15189","35122","25064","1361","1958","DeSoto County, Florida","12","027"
"5833","1657","178","23","25133","8557","5611","5262","349","16576","11588","10483","1105","25133","46494","0.4589","39.8","29033","65174","55042","1110","858","Columbia County, Florida","12","023"
"2802","1123","82","71","28943","11997","7122","6577","545","16946","12690","11479","1211","28943","37670","0.4584","38.2","37415","72177","59186","814","630","Putnam County, Florida","12","107"
"3126","178","2","39","3960","1185","810","778","32","2775","2209","2032","177","3960","44270","0.4873","39.6","4608","9538","8388","77","42","Union County, Florida","12","125"
"2216","760","56","14","16374","6831","4285","4004","281","9543","7057","6295","762","16374","37326","0.4524","39.1","20601","40142","32951","650","457","Levy County, Florida","12","075"
"17678","13961","3477","2325","216495","88157","54460","50383","4077","128338","94064","81966","12098","216495","49494","0.4594","38.3","260720","531217","437753","22158","10237","Volusia County, Florida","12","127"
"1403","79","104","40","6778","2573","1433","1382","51","4205","3158","2850","308","6778","37037","0.4797","39.1","8639","16371","13810","254","231","Madison County, Florida","12","079"
"8766","17860","1519","917","120104","37357","23661","22385","1276","82747","57815","49180","8635","120104","50915","0.4448","38.8","141355","297945","255383","7327","4412","Escambia County, Florida","12","033"
"6557","13989","1642","443","77962","22328","13495","12750","745","55634","41891","37571","4320","77962","63412","0.4328","39.5","97058","190732","158164","6694","3521","Okaloosa County, Florida","12","091"
"2176","1297","100","49","11570","3869","2457","2368","89","7701","6292","5432","860","11570","51790","0.4738","37.1","13607","32075","27480","390","486","Lumpkin County, Georgia","13","187"
"282","57","6","44","2333","864","496","490","6","1469","1161","1066","95","2333","44542","0.4732","39.4","2765","5625","4748","9","15","Miller County, Georgia","13","201"
"2297","713","67","8","13423","3996","2662","2619","43","9427","8298","8108","190","13423","90751","0.4623","38.9","14217","37924","33178","1327","890","Oconee County, Georgia","13","219"
"12253","5653","515","1029","75984","17865","13316","12947","369","58119","48066","45864","2202","75984","71288","0.3919","39.6","81428","224123","186843","10122","3991","Henry County, Georgia","13","151"
"2160","896","0","10","5695","944","690","661","29","4751","3709","3485","224","5695","54605","0.3787","42.8","6850","17822","14630","132","310","Long County, Georgia","13","183"
"1225","476","158","0","9543","3508","2274","2253","21","6035","4752","4530","222","9543","47164","0.4525","38.6","12624","25750","21874","331","67","Stephens County, Georgia","13","257"
"545","109","0","0","5279","1628","1058","1018","40","3651","2945","2772","173","5279","36669","0.4357","38.3","6521","14941","11951","124","120","Jeff Davis County, Georgia","13","161"
"984","24","20","2","1736","636","387","349","38","1100","909","803","106","1736","34167","0.4748","40.8","2399","4447","3679","3","7","Calhoun County, Georgia","13","037"
"8798","2159","582","639","58116","16379","9698","9181","517","41737","28103","25718","2385","58116","41334","0.5200","38.3","70130","149723","126618","2368","1368","Bibb County, Georgia","13","021"
"126","272","16","40","3408","1220","747","747","0","2188","1693","1649","44","3408","44643","0.4344","41.0","4200","8332","7261","163","20","Marion County, Georgia","13","197"
"910","98","7","0","4176","1572","918","891","27","2604","1967","1836","131","4176","48174","0.4415","38.8","5323","12434","11043","134","74","Bleckley County, Georgia","13","023"
"1079","267","39","31","8460","2966","1828","1758","70","5494","4515","4365","150","8460","42488","0.4911","38.3","10660","22557","18714","185","334","Franklin County, Georgia","13","119"
"1246","208","31","2","6494","2209","1374","1372","2","4285","2667","2374","293","6494","44846","0.4783","38.3","7591","18417","15865","156","73","Lamar County, Georgia","13","171"
"1649","538","59","57","8387","2506","1632","1591","41","5881","4432","4092","340","8387","37453","0.4610","40.1","9935","21749","17693","89","125","Emanuel County, Georgia","13","107"
"529","174","30","6","5171","1797","1246","1225","21","3374","2766","2582","184","5171","51250","0.4159","39.9","6445","13825","11937","109","99","Jasper County, Georgia","13","159"
"3810","6584","1041","176","23485","3857","2640","2539","101","19628","15216","14118","1098","23485","48007","0.3971","42.5","28212","55089","46112","1671","1153","Liberty County, Georgia","13","179"
"268","92","11","32","3363","1299","849","818","31","2064","1439","1344","95","3363","33357","0.6006","39.7","4832","8212","6844","16","35","Seminole County, Georgia","13","253"
"80","61","4","12","3044","1332","738","738","0","1712","1144","1100","44","3044","34879","0.4787","40.2","4253","8166","7269","7","110","Twiggs County, Georgia","13","289"
"235","118","16","7","3473","1196","717","682","35","2277","1620","1526","94","3473","33832","0.4839","39.3","4605","8046","6595","39","0","Taylor County, Georgia","13","269"
"1503","789","0","44","10030","3109","1732","1670","62","6921","5261","4867","394","10030","40175","0.5396","40.3","12218","26722","21066","340","438","Toombs County, Georgia","13","279"
"981","319","41","3","16251","5275","3391","3267","124","10976","8776","8099","677","16251","58957","0.4027","39.4","17902","40773","37847","188","141","Preble County, Ohio","39","135"
"3231","2198","346","325","40650","12299","7412","7087","325","28351","21018","19194","1824","40650","53131","0.4328","38.0","45081","100774","93534","645","468","Allen County, Ohio","39","003"
"1577","243","72","54","17782","5974","3467","3352","115","11808","8790","7877","913","17782","44971","0.4519","38.6","20044","41253","38402","255","224","Crawford County, Ohio","39","033"
"1159","440","0","47","16220","5460","3220","3004","216","10760","8281","7355","926","16220","45917","0.4392","39.2","19335","38683","35598","219","98","Guernsey County, Ohio","39","059"
"1094","453","114","80","16234","4752","2914","2748","166","11482","9208","8713","495","16234","62952","0.3934","39.3","18032","40467","38685","168","205","Mercer County, Ohio","39","107"
"5127","2299","408","446","54696","18351","10692","10292","400","36345","28180","25167","3013","54696","50873","0.4306","38.1","61272","133040","122816","1158","708","Clark County, Ohio","39","023"
"10041","4128","996","1017","120281","38386","23330","22146","1184","81895","62531","57338","5193","120281","58427","0.4506","38.0","131211","301415","277820","5082","3025","Lorain County, Ohio","39","093"
"16845","11760","2443","6060","224328","67230","38698","36601","2097","157098","110232","97663","12569","224328","51542","0.4659","37.9","254810","523385","467462","12281","8970","Montgomery County, Ohio","39","113"
"12211","4808","1641","468","82957","21430","14231","13853","378","61527","51568","48301","3267","82957","87125","0.4317","38.9","87165","221527","199211","7681","6366","Warren County, Ohio","39","165"
"2757","1191","82","171","37832","12683","7536","7216","320","25149","18761","16802","1959","37832","46700","0.4508","38.1","46174","94978","84618","739","415","Ashtabula County, Ohio","39","007"
"1897","1595","128","32","17610","5864","3446","3290","156","11746","8676","7732","944","17610","46809","0.4570","39.7","21515","43691","36985","397","423","Kay County, Oklahoma","40","071"
"829","232","6","0","5422","1925","1200","1177","23","3497","2710","2506","204","5422","43329","0.4241","39.5","6753","13593","11466","50","56","Craig County, Oklahoma","40","035"
"7210","3330","244","141","44906","11855","7643","7491","152","33051","27282","25725","1557","44906","72056","0.3989","39.9","48467","138461","119736","3162","1422","Canadian County, Oklahoma","40","017"
"457","269","17","3","4088","1554","974","930","44","2534","2046","1932","114","4088","44214","0.4874","40.6","5050","10137","8000","78","18","Latimer County, Oklahoma","40","077"
"336","423","259","36","6768","1661","940","853","87","5107","3948","3669","279","6768","52282","0.3852","41.3","8232","20685","13421","861","2492","Texas County, Oklahoma","40","139"
"446","194","9","0","4477","1752","1052","1016","36","2725","2049","1950","99","4477","37692","0.4864","40.5","6179","11018","8964","19","8","Pushmataha County, Oklahoma","40","127"
"391","226","2","20","4267","1536","943","902","41","2731","2054","1968","86","4267","41332","0.4354","40.7","5197","10942","9015","57","38","Johnston County, Oklahoma","40","069"
"94","136","24","4","1971","629","422","412","10","1342","1108","1037","71","1971","52349","0.4062","42.6","2682","5298","4301","81","200","Beaver County, Oklahoma","40","007"
"546","64","16","12","4132","1641","978","956","22","2491","1896","1822","74","4132","39365","0.4744","40.0","6267","11921","9488","51","46","Hughes County, Oklahoma","40","063"
"3881","12133","1458","684","42842","10530","6180","5809","371","32312","24145","22076","2069","42842","52161","0.4456","41.5","51637","108744","89362","2954","2229","Comanche County, Oklahoma","40","031"
"545","420","33","7","7733","2488","1608","1542","66","5245","4320","4043","277","7733","34695","0.4472","39.6","9380","22078","15899","96","123","Adair County, Oklahoma","40","001"
"1032","849","27","13","16720","5615","3332","3230","102","11105","8659","8039","620","16720","47214","0.4500","40.2","20710","43057","36417","437","395","Stephens County, Oklahoma","40","137"
"1114","1039","268","34","18339","5465","3347","3255","92","12874","9515","8831","684","18339","51419","0.4447","40.4","21723","47692","39357","438","628","Carter County, Oklahoma","40","019"
"946","162","9","0","2054","775","352","331","21","1279","987","955","32","2054","41488","0.4345","41.5","2715","4822","3988","3","13","Greer County, Oklahoma","40","055"
"406","115","8","35","8327","3555","2230","2156","74","4772","3609","3384","225","8327","39084","0.4593","40.1","13777","19438","15515","90","20","McIntosh County, Oklahoma","40","091"
"445","237","8","0","5238","1641","1097","1037","60","3597","2636","2417","219","5238","52478","0.4330","41.0","6847","13563","11501","132","51","Murray County, Oklahoma","40","099"
"947","779","44","39","11847","3909","2355","2261","94","7938","6159","5696","463","11847","39872","0.4474","39.0","14063","30996","25240","199","242","Ottawa County, Oklahoma","40","115"
"5665","1177","78","93","29208","8619","6031","5874","157","20589","16939","15814","1125","29208","62795","0.4048","39.9","32290","78663","67637","1241","843","Wagoner County, Oklahoma","40","145"
"1086","589","130","43","10320","3468","1997","1881","116","6852","5501","5154","347","10320","46592","0.4474","42.3","13225","27929","22815","160","124","Caddo County, Oklahoma","40","015"
"3807","1740","103","155","26234","8047","4588","4402","186","18187","14117","13438","679","26234","43078","0.4877","39.2","30981","65760","53843","524","563","Muskogee County, Oklahoma","40","101"
"1143","2152","51","49","17253","5737","3491","3351","140","11516","9040","8032","1008","17253","44212","0.4618","39.7","20333","45993","37151","288","311","Bryan County, Oklahoma","40","013"
"4860","6883","473","958","88241","32891","20098","18531","1567","55350","43518","37585","5933","88241","53412","0.4662","37.2","95431","215294","188779","5625","5072","Jackson County, Oregon","41","029"
"122","207","1","0","3381","1443","817","785","32","1938","1440","1173","267","3381","44712","0.4410","40.5","4407","7090","6502","141","59","Grant County, Oregon","41","023"
"18663","9715","1512","5972","157408","50785","32758","30852","1906","106623","87041","77718","9323","157408","80484","0.4457","38.6","167104","408754","358524","18726","9883","Clackamas County, Oregon","41","005"
"921","622","46","80","10784","4515","2830","2644","186","6269","4686","4035","651","10784","49895","0.4248","37.6","19000","25781","23141","404","438","Tillamook County, Oregon","41","057"
"2548","2788","95","100","36367","15692","10361","9518","843","20675","16060","14148","1912","36367","45616","0.4513","36.9","39103","85640","75869","1459","1458","Josephine County, Oregon","41","033"
"2526","2104","351","170","26908","8018","5042","4769","273","18890","15428","13799","1629","26908","54699","0.4319","39.2","30499","72736","61566","2128","3717","Umatilla County, Oregon","41","059"
"2483","1932","62","108","19671","6588","4238","3974","264","13083","10299","9197","1102","19671","62257","0.4357","38.7","21315","51097","47198","713","354","Columbia County, Oregon","41","009"
"1201","686","64","29","10305","3560","2241","2064","177","6745","5154","4538","616","10305","53105","0.4141","38.3","11678","25712","22100","415","1192","Wasco County, Oregon","41","065"
"836","80","14","13","3097","985","619","556","63","2112","1652","1546","106","3097","41996","0.4991","39.3","3973","8583","7048","186","98","Montgomery County, Georgia","13","209"
"5725","2677","121","388","31076","8750","6169","5910","259","22326","17846","16876","970","31076","60189","0.4229","39.3","33681","88912","70097","4769","1864","Rockdale County, Georgia","13","247"
"263","27","0","0","1862","753","423","412","11","1109","765","747","18","1862","30192","0.4452","39.7","2634","7706","6045","6","2","Wheeler County, Georgia","13","309"
"589","207","55","10","6740","2230","1469","1461","8","4510","3472","3414","58","6740","47811","0.4162","39.6","7739","18689","15217","204","413","Banks County, Georgia","13","011"
"15845","5151","910","2694","48844","9909","5871","5494","377","38935","26729","18652","8077","48844","38623","0.5220","34.8","52941","125443","100502","3128","4932","Clarke County, Georgia","13","059"
"4031","1915","159","192","34119","11756","7223","6912","311","22363","16724","15343","1381","34119","52977","0.5123","38.9","43110","83446","69101","1750","837","Glynn County, Georgia","13","127"
"3019","917","162","132","23166","6934","5003","4819","184","16232","13932","13028","904","23166","65385","0.4291","40.0","25388","67179","56657","1540","1050","Jackson County, Georgia","13","157"
"1142","212","0","6","10701","3631","2259","2217","42","7070","5851","5453","398","10701","56020","0.4271","39.9","11843","28298","25218","154","130","Jones County, Georgia","13","169"
"6929","12084","1706","1070","72759","18616","10586","10159","427","54143","37606","34642","2964","72759","46408","0.4980","39.3","84723","185535","156285","4924","2939","Muscogee County, Georgia","13","215"
"621","603","638","0","1816","695","408","398","10","1121","752","740","12","1816","29732","0.4880","39.7","2346","4081","3399","17","0","Stewart County, Georgia","13","259"
"518","74","0","8","3169","1133","721","702","19","2036","1687","1595","92","3169","37039","0.4761","40.1","3938","7650","6557","45","62","Turner County, Georgia","13","287"
"121","9","0","0","2880","803","479","477","2","2077","1590","1499","91","2880","37197","0.4735","39.4","3512","8217","6030","74","260","Atkinson County, Georgia","13","003"
"134","8","0","0","1425","537","303","294","9","888","520","494","26","1425","32917","0.4874","40.5","1924","3132","2691","33","46","Baker County, Georgia","13","007"
"406","270","9","0","4013","1253","697","675","22","2760","2182","2100","82","4013","33736","0.5252","39.1","4770","10553","8155","31","51","Candler County, Georgia","13","043"
"7763","2455","324","230","41903","11328","7708","7320","388","30575","24845","22438","2407","41903","53737","0.4280","39.2","45374","115960","98932","1143","1588","Carroll County, Georgia","13","045"
"1025","287","12","29","8585","2890","1549","1549","0","5695","4360","4163","197","8585","36042","0.5545","38.5","10792","22303","18572","79","148","Crisp County, Georgia","13","081"
"32655","21433","6401","3826","280374","62219","42092","40331","1761","218155","167211","149208","18003","280374","77932","0.4501","39.8","300047","746238","573791","47667","32962","Cobb County, Georgia","13","067"
"583","935","73","18","6195","2163","1388","1336","52","4032","3399","3203","196","6195","42581","0.4437","36.9","7290","15973","13782","102","126","Dade County, Georgia","13","083"
"540","418","12","45","6335","2211","1252","1232","20","4124","2976","2783","193","6335","38285","0.5482","39.9","7791","15494","12453","71","167","Brooks County, Georgia","13","027"
"814","453","13","10","7559","2831","1594","1535","59","4728","3777","3530","247","7559","38678","0.4702","38.5","9630","18934","16084","143","205","Elbert County, Georgia","13","105"
"252","19","29","0","3443","1130","603","580","23","2313","1703","1515","188","3443","27375","0.4417","38.1","4821","8717","7059","178","9","Jenkins County, Georgia","13","165"
"5544","3242","221","333","37018","9736","7126","6834","292","27282","21508","19787","1721","37018","56316","0.4388","39.2","39312","107131","88636","3042","1564","Newton County, Georgia","13","217"
"1556","1361","180","265","15505","4680","3107","2910","197","10825","8408","7753","655","15505","36435","0.4841","39.5","18650","45058","33987","601","969","Colquitt County, Georgia","13","071"
"19954","7586","940","4202","94279","18681","12991","12285","706","75598","54682","50535","4147","94279","47864","0.4147","38.6","105593","279870","204346","13792","10218","Clayton County, Georgia","13","063"
"8241","3896","708","246","64352","19111","13301","12970","331","45241","37878","35179","2699","64352","62984","0.4596","39.7","73135","197765","146312","7667","9502","Hall County, Georgia","13","139"
"2187","4394","1801","1984","54479","20323","15027","14195","832","34156","27035","24054","2981","54479","80948","0.4403","38.4","73169","164492","128171","16358","11799","Maui County, Hawaii","15","009"
"13","264","0","0","1615","577","368","355","13","1038","822","802","20","1615","53841","0.3583","37.7","1999","4356","3951","36","35","Oneida County, Idaho","16","071"
"563","332","8","4","6683","2677","1693","1632","61","4006","3154","2953","201","6683","45492","0.4175","38.7","7349","17205","13943","133","144","Gem County, Idaho","16","045"
"387","241","12","12","1757","886","588","568","20","871","656","636","20","1757","48856","0.4392","39.2","2690","4072","3547","22","14","Adams County, Idaho","16","003"
"1403","488","335","86","8022","2107","1308","1180","128","5915","5119","4525","594","8022","52921","0.4114","41.4","8531","23616","17535","461","1219","Jerome County, Idaho","16","053"
"197","107","2","6","1646","713","370","341","29","933","668","578","90","1646","41198","0.4534","39.5","1948","3809","3169","45","19","Lewis County, Idaho","16","061"
"820","532","56","24","4321","1496","988","903","85","2825","2346","2210","136","4321","43798","0.4434","41.8","4914","11448","8489","173","309","Owyhee County, Idaho","16","073"
"466","519","40","22","4653","1688","1099","1043","56","2965","2082","1834","248","4653","43423","0.4787","37.8","5474","11762","9432","147","194","Boundary County, Idaho","16","021"
"101","140","35","0","2538","795","469","454","15","1743","1447","1379","68","2538","59053","0.4049","38.5","3291","6878","6210","68","69","Caribou County, Idaho","16","029"
"3841","3093","447","401","31155","8417","5156","4902","254","22738","17411","15159","2252","31155","51734","0.4402","36.8","34279","84697","74288","1144","1773","Bannock County, Idaho","16","005"
"4054","4429","624","1524","39768","10598","6731","6491","240","29170","23481","22062","1419","39768","60615","0.4504","37.7","42925","113366","99552","2305","2090","Bonneville County, Idaho","16","019"
"7975","8194","891","261","72807","20147","13343","12795","548","52660","41984","38283","3701","72807","52134","0.4080","38.7","76247","216118","175252","5471","5959","Canyon County, Idaho","16","027"
"2545","2200","325","230","15422","3586","2220","2117","103","11836","8599","6356","2243","15422","49158","0.4568","35.4","16960","39345","34581","748","1440","Latah County, Idaho","16","057"
"5316","2791","616","1336","83711","23885","13611","12894","717","59826","42056","37329","4727","83711","61912","0.4589","37.9","91737","194848","181414","3042","2760","Sangamon County, Illinois","17","167"
"1698","270","62","7","11883","3972","2326","2263","63","7911","5939","5522","417","11883","53816","0.4295","39.0","13944","28544","26838","86","125","Randolph County, Illinois","17","157"
"1718","707","84","124","21021","6477","3755","3604","151","14544","11346","10508","838","21021","60986","0.4052","40.3","22663","50520","46371","825","963","Ogle County, Illinois","17","141"
"2009","552","29","111","13719","4503","2445","2322","123","9216","6660","6079","581","13719","51437","0.4234","37.5","15463","32076","30384","240","303","Morgan County, Illinois","17","137"
"291","112","7","21","6041","2041","1120","1073","47","4000","3048","2930","118","6041","49290","0.4205","39.6","7164","13527","12725","99","51","White County, Illinois","17","193"
"174","159","7","18","2977","1171","759","711","48","1806","1434","1295","139","2977","53676","0.3930","38.9","3868","6754","6302","42","18","Henderson County, Illinois","17","071"
"9476","2669","639","933","65845","15435","9175","8874","301","50410","37642","31329","6313","65845","67675","0.4725","36.4","72384","171425","154218","4180","6216","McLean County, Illinois","17","113"
"1223","162","18","66","8433","2772","1584","1520","64","5661","4404","4141","263","8433","52428","0.4590","39.0","9610","18617","17768","87","30","Perry County, Illinois","17","145"
"3236","3677","413","1047","60546","19333","10753","10393","360","41213","29873","27132","2741","60546","54858","0.4286","37.8","66160","141174","124163","4115","5520","Rock Island County, Illinois","17","161"
"154","184","5","8","4839","1674","985","929","56","3165","2397","2296","101","4839","50770","0.4340","39.0","5570","11466","10495","57","99","Wabash County, Illinois","17","185"
"599","23","17","7","4299","1440","841","817","24","2859","2321","2130","191","4299","56206","0.4103","38.5","4872","10711","10065","48","30","Cumberland County, Illinois","17","035"
"579","527","14","75","9970","3996","2427","2288","139","5974","4422","3977","445","9970","57946","0.4334","39.3","13699","21432","19980","189","166","Jo Daviess County, Illinois","17","085"
"1003","504","17","21","6306","2049","1160","1109","51","4257","3237","2997","240","6306","46636","0.4263","40.6","7129","13675","12491","118","33","Lawrence County, Illinois","17","101"
"429","67","40","0","4884","1755","979","963","16","3129","2359","2157","202","4884","58465","0.4162","38.4","5919","11415","10834","112","62","Marshall County, Illinois","17","123"
"1117","467","92","76","13901","4692","2578","2325","253","9209","6958","6255","703","13901","52834","0.4230","39.1","15614","31256","29637","104","158","Christian County, Illinois","17","021"
"5573","1877","662","371","23883","5945","3459","3302","157","17938","11493","8976","2517","23883","37241","0.5249","34.3","28962","57450","50781","974","2033","Jackson County, Illinois","17","077"
"5047","2175","624","1514","73253","21177","11919","11495","424","52076","35956","32202","3754","73253","55842","0.4842","37.7","83703","180546","161968","4171","4645","Peoria County, Illinois","17","143"
"729","124","4","23","6692","2168","1331","1289","42","4524","3557","3433","124","6692","70849","0.3865","38.9","7406","16347","15525","85","96","Piatt County, Illinois","17","147"
"104","30","0","7","2315","792","444","434","10","1523","1155","1091","64","2315","54907","0.4554","39.6","2653","5345","5001","31","22","Stark County, Illinois","17","175"
"962","314","35","30","6299","2090","1181","1120","61","4209","3383","2990","393","6299","57289","0.4307","37.6","7238","15347","14186","120","161","Bond County, Illinois","17","005"
"489","318","25","14","6508","2521","1434","1367","67","3987","2964","2656","308","6508","52410","0.4198","39.6","8475","14182","13081","187","52","Carroll County, Illinois","17","015"
"901","333","74","9","8499","2903","1694","1657","37","5596","4460","4096","364","8499","63028","0.3975","38.5","10148","21588","20490","64","130","Jersey County, Illinois","17","083"
"13706","8058","2535","6050","114170","29472","20038","19337","701","84698","69633","64494","5139","114170","121160","0.4092","39.0","119494","315151","242280","39115","21522","Howard County, Maryland","24","027"
"19077","31704","8071","72077","311343","83263","54719","51951","2768","228080","166196","151510","14686","311343","84920","0.3994","38.5","333041","901883","663269","81523","66327","Prince George's County, Maryland","24","033"
"20079","18407","3417","10606","209814","58270","38629","36496","2133","151544","119881","110000","9881","209814","100798","0.4133","39.6","224378","547742","485105","24788","13811","Anne Arundel County, Maryland","24","003"
"26514","12840","5546","19150","313519","98152","58394","55480","2914","215367","164141","148115","16026","313519","76866","0.4520","38.7","337052","819867","690282","52418","34290","Baltimore County, Maryland","24","005"
"7788","6215","1088","3193","92526","24949","16245","15634","611","67577","55734","50587","5147","92526","97730","0.4045","38.8","97486","249075","215326","14220","8366","Frederick County, Maryland","24","021"
"3309","2060","481","1520","31973","9264","6552","6402","150","22709","19174","17709","1465","31973","109313","0.3768","39.2","35155","90150","84295","1558","814","Calvert County, Maryland","24","009"
"533","601","42","55","12425","4485","2690","2595","95","7940","6149","5640","509","12425","52617","0.4475","39.1","19338","28751","26462","193","96","Garrett County, Maryland","24","023"
"668","800","102","141","8025","3489","2054","1951","103","4536","3299","2896","403","8025","58598","0.4773","37.6","10686","19161","17502","220","434","Kent County, Maryland","24","029"
"17841","33417","16627","81686","370950","107130","70315","67352","2963","263820","208169","191894","16275","370950","108820","0.4648","39.2","389202","1034552","676173","172281","112182","Montgomery County, Maryland","24","031"
"391","194","9","34","4489","1005","850","809","41","3484","2853","2606","247","4489","53553","0.4502","36.9","6027","17878","13955","156","130","Bethel Census Area, Alaska","02","050"
"461","328","15","114","1979","428","300","297","3","1551","1351","1226","125","1979","79306","0.4094","60.7","2618","9732","7353","304","268","North Slope Borough, Alaska","02","185"
"467","448","71","54","3547","989","608","597","11","2558","1809","1526","283","3547","73682","0.4185","43.3","4225","8396","6447","333","246","Sitka City and Borough, Alaska","02","220"
"1856","6718","790","457","36188","7044","4667","4274","393","29144","22400","19548","2852","36188","76992","0.4094","41.6","44189","91918","78603","2619","1707","Fairbanks North Star Borough, Alaska","02","090"
"244","667","95","273","5397","1475","935","879","56","3922","2971","2574","397","5397","72728","0.4332","41.6","6401","13495","10832","723","403","Ketchikan Gateway Borough, Alaska","02","130"
"3913","2987","399","325","31217","7497","5200","4838","362","23720","18889","17255","1634","31217","75493","0.4220","41.1","41815","103269","85222","1791","935","Matanuska-Susitna Borough, Alaska","02","170"
"268","269","13","11","2844","613","479","461","18","2231","1802","1667","135","2844","61048","0.4301","39.1","4108","9761","7582","63","97","Nome Census Area, Alaska","02","180"
"197","88","6","10","1427","317","221","214","7","1110","890","827","63","1427","56898","0.4271","39.8","2456","4942","3800","85","23","Dillingham Census Area, Alaska","02","070"
"21","63","0","1","219","70","41","36","5","149","98","91","7","219","71607","0.3385","46.0","418","649","477","7","11","Yakutat City and Borough, Alaska","02","282"
"37","21","4","0","421","88","61","57","4","333","241","223","18","421","44135","0.4259","42.4","1479","1393","904","3","21","Lake and Peninsula Borough, Alaska","02","164"
"402","301","44","10","2170","683","468","465","3","1487","1115","1006","109","2170","70056","0.4058","43.6","3904","6780","5027","449","143","Southeast Fairbanks Census Area, Alaska","02","240"
"5215","12312","2715","2321","106567","22057","14493","13218","1275","84510","64014","55425","8589","106567","84928","0.4298","40.5","117380","282365","224591","16270","9847","Anchorage Municipality, Alaska","02","020"
"88","218","77","6","890","206","137","135","2","684","508","415","93","890","69250","0.4068","59.5","1138","3380","1385","143","287","Aleutians East Borough, Alaska","02","013"
"258","569","10","31","3177","738","455","426","29","2439","1701","1555","146","3177","79867","0.4130","43.5","6181","9034","6793","167","337","Valdez-Cordova Census Area, Alaska","02","261"
"1599","2143","167","73","21630","6683","4096","3864","232","14947","10936","9739","1197","21630","66064","0.4393","41.9","31249","57367","46708","1025","474","Kenai Peninsula Borough, Alaska","02","122"
"55","89","9","5","375","95","67","53","14","280","191","147","44","375","73906","0.3023","48.0","601","1107","833","52","20","Skagway Municipality, Alaska","02","230"
"170","237","8","41","2371","754","450","422","28","1617","1203","1103","100","2371","52379","0.4326","43.3","3430","6407","4649","101","76","Prince of Wales-Hyder Census Area, Alaska","02","198"
"91","145","12","12","1187","464","307","294","13","723","543","472","71","1187","69948","0.4274","47.2","1782","3247","2671","152","113","Petersburg Borough, Alaska","02","195"
"121","49","0","2","1724","369","323","322","1","1355","1182","1118","64","1724","36754","0.4285","39.4","2231","8236","6587","1","6","Kusilvak Census Area, Alaska","02","158"
"35232","150855","26707","40675","1552096","438707","286708","269301","17407","1113389","851595","749422","102173","1552096","64468","0.4641","38.9","1740694","4297311","3359943","238326","242458","Maricopa County, Arizona","04","013"
"2843","1133","235","22","11017","3561","2392","2299","93","7456","5917","5487","430","11017","51353","0.4196","37.6","13586","34503","31647","298","187","Graham County, Arizona","04","009"
"1067","533","923","134","15853","5690","3957","3808","149","10163","8509","8208","301","15853","41259","0.4997","38.5","18334","46061","28638","7791","4916","Santa Cruz County, Arizona","04","023"
"276","970","333","20","9346","5194","3524","3230","294","4152","2904","2700","204","9346","34643","0.4879","39.8","16300","20651","16371","554","686","La Paz County, Arizona","04","012"
"3125","13982","919","704","86889","42086","27896","25886","2010","44803","33760","29576","4184","86889","45587","0.4456","38.2","114573","204435","176125","6028","4064","Mohave County, Arizona","04","015"
"10308","7995","709","1059","47447","12061","8245","7856","389","35386","26754","20993","5761","47447","59460","0.4667","36.5","66086","140443","119836","2449","2421","Coconino County, Arizona","04","005"
"7660","10367","615","303","98386","48010","30510","28524","1986","50376","37595","32888","4707","98386","52451","0.4435","37.2","116842","226584","193878","7062","3471","Yavapai County, Arizona","04","025"
"858","327","10","0","3132","827","587","560","27","2305","1867","1779","88","3132","63473","0.3805","41.1","4453","9477","8860","86","91","Greenlee County, Arizona","04","011"
"25062","18541","2352","381","141300","55571","38785","36591","2194","85729","67610","62486","5124","141300","58174","0.4204","39.1","174329","406677","342012","15706","13007","Pinal County, Arizona","04","021"
"507","575","0","12","3397","1166","761","757","4","2231","1666","1506","160","3397","38042","0.4086","39.6","4606","8193","7423","2","1","Nevada County, Arkansas","05","099"
"810","194","9","5","6653","2172","1461","1347","114","4481","3592","3305","287","6653","46787","0.4593","41.3","7956","16598","15307","10","5","Cross County, Arkansas","05","037"
"583","277","0","2","2969","1209","640","627","13","1760","1212","1170","42","2969","38072","0.4249","38.7","4346","6519","6093","4","1","Dallas County, Arkansas","05","039"
"1183","767","35","12","8562","2895","1404","1339","65","5667","4439","4220","219","8562","36193","0.4973","36.8","11666","23354","21359","137","199","Columbia County, Arkansas","05","027"
"5357","2255","234","48","44075","13905","9052","8799","253","30170","23912","22497","1415","44075","64412","0.3990","39.8","48619","118198","108262","1695","1185","Saline County, Arkansas","05","125"
"737","351","66","0","6813","3033","1811","1695","116","3780","3017","2936","81","6813","38499","0.4504","39.1","10488","16457","14794","45","37","Van Buren County, Arkansas","05","141"
"742","267","0","0","4851","2030","1372","1313","59","2821","1942","1811","131","4851","42876","0.4278","40.2","7279","12634","11737","23","91","Izard County, Arkansas","05","065"
"1609","616","38","43","14322","4473","2765","2688","77","9849","7765","7241","524","14322","44319","0.4561","38.4","16525","36939","33015","310","387","Independence County, Arkansas","05","063"
"1095","403","2","39","8417","2997","1878","1773","105","5420","4298","4066","232","8417","41466","0.4243","39.7","10163","21420","19712","186","101","Logan County, Arkansas","05","083"
"910","319","3","0","6863","2268","1562","1515","47","4595","3639","3492","147","6863","55388","0.4471","40.4","8008","17949","16840","72","182","Grant County, Arkansas","05","053"
"1174","329","20","54","6723","2348","1387","1354","33","4375","3446","3183","263","6723","38923","0.4533","38.9","8024","17449","16293","162","42","Franklin County, Arkansas","05","047"
"482","136","17","3","4280","1545","922","879","43","2735","2139","2090","49","4280","40401","0.4481","40.1","5631","10598","9404","90","136","Pike County, Arkansas","05","109"
"3711","873","297","65","26801","8469","4910","4731","179","18332","12716","11563","1153","26801","40726","0.4642","39.0","33389","64532","59190","381","582","Jefferson County, Arkansas","05","069"
"390","211","9","6","3754","1631","949","939","10","2123","1688","1624","64","3754","35741","0.4540","37.9","5845","8815","7824","36","56","Montgomery County, Arkansas","05","097"
"264","209","11","3","3944","1455","918","902","16","2489","1752","1667","85","3944","36092","0.4331","39.1","5281","10312","9109","154","14","Scott County, Arkansas","05","127"
"4072","3821","416","170","51228","14358","8232","7785","447","36870","27747","25124","2623","51228","46228","0.4691","39.3","56841","126506","105652","4468","3275","Sebastian County, Arkansas","05","131"
"2149","1590","221","38","23958","7200","4662","4366","296","16758","13252","12716","536","23958","46828","0.4477","39.9","26836","62057","54906","766","1361","Crawford County, Arkansas","05","033"
"563","180","0","7","4068","1497","826","782","44","2571","1913","1854","59","4068","34147","0.5252","39.5","5415","9939","8944","31","43","Chicot County, Arkansas","05","017"
"753","365","98","36","9682","3054","1793","1754","39","6628","5209","4896","313","9682","38511","0.4491","38.7","11486","26188","21813","566","913","Johnson County, Arkansas","05","071"
"835","107","4","2","3206","1141","716","687","29","2065","1396","1307","89","3206","29681","0.5049","40.8","4364","7588","6955","6","82","Lee County, Arkansas","05","077"
"1708","1154","81","83","13365","4138","2463","2387","76","9227","7136","6495","641","13365","61038","0.3993","37.9","14236","32938","31321","311","208","Marion County, Iowa","19","125"
"833","521","56","34","8832","2720","1652","1572","80","6112","5045","4596","449","8832","62556","0.3951","40.2","9742","21769","19408","378","279","Washington County, Iowa","19","183"
"661","266","102","5","5718","1897","1084","1005","79","3821","2796","2548","248","5718","53333","0.4160","40.7","6514","12564","11490","158","328","Wright County, Iowa","19","197"
"451","211","27","70","5921","2065","1013","959","54","3856","2700","2410","290","5921","50187","0.4317","39.9","6577","12836","12125","13","135","Cass County, Iowa","19","029"
"342","243","3","6","5319","1745","1012","957","55","3574","2494","2211","283","5319","56550","0.4275","40.1","5770","10999","10379","83","86","Cherokee County, Iowa","19","035"
"494","149","47","2","6437","2001","1186","1156","30","4436","3701","3328","373","6437","55755","0.4913","42.2","7065","16857","13233","602","1558","Crawford County, Iowa","19","047"
"1043","1288","45","71","16891","5698","3142","3018","124","11193","8259","7348","911","16891","51267","0.4619","38.7","18603","38894","36439","197","347","Des Moines County, Iowa","19","057"
"740","262","53","25","8200","2827","1581","1545","36","5373","4192","3786","406","8200","51128","0.4506","39.0","9597","19470","18361","60","83","Fayette County, Iowa","19","065"
"282","417","6","12","6019","1858","1102","1074","28","4161","3353","3016","337","6019","63854","0.4217","40.8","6821","13845","13210","53","42","Harrison County, Iowa","19","085"
"427","340","21","41","6646","2287","1300","1256","44","4359","3269","2997","272","6646","56073","0.4163","40.9","7508","14750","13858","68","94","Kossuth County, Iowa","19","109"
"719","477","0","60","5554","1726","1163","1110","53","3828","2989","2803","186","5554","72079","0.4219","38.8","6133","14836","14065","95","64","Mills County, Iowa","19","129"
"460","145","10","12","4000","1439","710","669","41","2561","1955","1758","197","4000","47605","0.4506","40.1","4722","8519","8089","11","4","Monona County, Iowa","19","133"
"728","340","137","128","16660","4777","2725","2602","123","11883","9478","8582","896","16660","58453","0.4179","39.5","18159","42309","38252","1193","1259","Muscatine County, Iowa","19","139"
"163","179","1","9","2633","879","491","464","27","1754","1352","1169","183","2633","59725","0.4047","41.5","2956","5970","5597","34","72","Osceola County, Iowa","19","143"
"16131","11874","1641","3695","187798","43930","25901","24451","1450","143868","107097","92996","14101","187798","67637","0.4403","39.1","200593","474865","416117","17038","18286","Polk County, Iowa","19","153"
"1911","839","60","92","15306","4777","2333","2263","70","10529","7471","6572","899","15306","47466","0.4456","39.3","17022","34763","32073","360","402","Webster County, Iowa","19","187"
"7254","5212","1106","3147","37811","7776","4784","4574","210","30035","22150","14704","7446","37811","56756","0.4660","34.2","39962","96284","84300","2079","5600","Story County, Iowa","19","169"
"1700","2797","133","466","39016","10827","6202","5946","256","28189","22113","19826","2287","39016","59224","0.4293","39.3","42260","101611","89378","3908","2501","Woodbury County, Iowa","19","193"
"5774","2637","635","332","52905","14691","8458","8111","347","38214","28083","23319","4764","52905","53539","0.4694","37.0","57894","131172","117597","3253","3806","Black Hawk County, Iowa","19","013"
"597","122","39","18","5155","1662","993","973","20","3493","2801","2586","215","5155","68038","0.4184","41.1","5584","12139","11836","42","20","Grundy County, Iowa","19","075"
"800","252","15","23","8130","2724","1591","1523","68","5406","4071","3820","251","8130","57549","0.4121","40.9","8985","19435","18610","117","104","Jones County, Iowa","19","105"
"265","71","10","3","4355","1563","802","787","15","2792","2154","2058","96","4355","58302","0.3954","39.8","4974","10403","9684","42","52","Mitchell County, Iowa","19","131"
"343","347","22","18","4554","1510","766","705","61","3044","2424","2194","230","4554","51696","0.4449","39.9","5233","9864","9333","46","136","Montgomery County, Iowa","19","137"
"362","123","31","8","4313","1505","879","849","30","2808","2166","2031","135","4313","58232","0.4248","40.7","5395","9630","9086","90","42","Sac County, Iowa","19","161"
"649","598","12","23","10250","3062","1859","1826","33","7188","5851","5474","377","10250","67297","0.4062","41.1","10834","24789","23106","281","173","Plymouth County, Iowa","19","149"
"1114","210","62","38","8029","2588","1448","1398","50","5441","4493","4171","322","8029","64837","0.4662","41.0","9094","20875","19669","96","55","Buchanan County, Iowa","19","019"
"891","1157","106","127","19635","6450","3587","3426","161","13185","9982","8865","1117","19635","51688","0.4263","39.4","22026","46471","44231","300","204","Clinton County, Iowa","19","045"
"389","315","43","4","3200","1065","674","664","10","2135","1564","1355","209","3200","44462","0.4422","37.0","3853","7864","6965","49","116","Decatur County, Iowa","19","053"
"644","457","468","5","6754","2602","1373","1263","110","4152","2975","2810","165","6754","47708","0.4886","39.6","7640","17990","15583","332","1255","Jefferson County, Iowa","19","101"
"286","220","24","9","5953","2060","1266","1193","73","3893","2873","2606","267","5953","52216","0.4155","41.0","7782","13531","12057","249","193","Allamakee County, Iowa","19","005"
"6289","5410","547","700","90877","24061","14131","13335","796","66816","49271","42804","6467","90877","64903","0.4277","38.9","97272","222016","205232","3913","4602","Linn County, Iowa","19","113"
"7269","2090","244","163","34399","7220","4140","3982","158","27179","21564","19543","2021","34399","88479","0.4255","40.4","36418","86620","77264","3604","3074","Dallas County, Iowa","19","049"
"596","242","45","196","6169","1925","1020","1011","9","4244","2983","2639","344","6169","53703","0.4170","39.3","6690","13620","12711","263","116","O'Brien County, Iowa","19","141"
"18","13","13","0","733","222","105","105","0","511","417","381","36","733","52054","0.4214","46.3","1013","2022","1602","66","52","Stanton County, Kansas","20","187"
"252","50","19","0","1689","518","259","248","11","1171","961","927","34","1689","59316","0.3997","42.3","1991","4057","3245","174","135","Meade County, Kansas","20","119"
"1091","929","42","0","13576","4566","2418","2352","66","9010","6573","5943","630","13576","45157","0.4434","38.0","16467","32010","27746","350","105","Montgomery County, Kansas","20","125"
"519","194","18","7","3652","1167","736","704","32","2485","1905","1699","206","3652","52327","0.4275","38.4","4480","9220","8348","50","104","Pratt County, Kansas","20","151"
"102","109","10","9","1176","433","287","285","2","743","518","466","52","1176","53207","0.4191","40.8","1418","2465","2228","25","18","Rawlins County, Kansas","20","153"
"486","254","21","0","3101","1162","675","668","7","1939","1553","1497","56","3101","50213","0.4384","40.0","3743","7708","6808","25","29","Anderson County, Kansas","20","003"
"410","136","8","10","2388","880","474","465","9","1508","1141","1058","83","2388","54902","0.3936","39.6","3237","5340","5017","24","5","Ellsworth County, Kansas","20","053"
"1966","3326","896","26","12684","1978","1159","1145","14","10706","8543","7940","603","12684","53133","0.3699","44.2","15344","28576","24998","1061","589","Geary County, Kansas","20","061"
"1584","705","285","18","11344","2412","1370","1328","42","8932","7385","6855","530","11344","51711","0.4126","40.7","12268","33657","22796","1976","4099","Ford County, Kansas","20","057"
"448","95","9","4","3015","1006","671","620","51","2009","1414","1259","155","3015","44792","0.4309","39.8","3878","6833","6091","17","19","Russell County, Kansas","20","167"
"243","157","19","4","4085","1429","767","729","38","2656","1990","1844","146","4085","51895","0.4138","40.4","4918","9575","8891","58","43","Marshall County, Kansas","20","117"
"543","295","14","82","5372","1752","1094","1058","36","3620","2591","2204","387","5372","45333","0.4205","39.8","6318","12353","11559","86","72","Allen County, Kansas","20","001"
"30","72","0","0","1221","513","208","197","11","708","511","479","32","1221","47639","0.4345","40.9","1504","2630","2353","20","29","Cheyenne County, Kansas","20","023"
"1255","989","386","14","13499","4349","2379","2229","150","9150","7118","6660","458","13499","50102","0.4184","39.2","16168","34140","29968","645","352","Cowley County, Kansas","20","035"
"75","76","2","0","1128","542","312","304","8","586","431","400","31","1128","38750","0.4583","37.9","1762","2501","2254","12","8","Elk County, Kansas","20","049"
"895","470","26","13","10118","2891","1849","1725","124","7227","5572","5065","507","10118","56582","0.4034","40.5","11246","25359","23104","235","164","Franklin County, Kansas","20","059"
"96","30","8","0","767","289","164","161","3","478","403","384","19","767","61211","0.3850","44.0","975","1844","1634","9","43","Hodgeman County, Kansas","20","083"
"35","10","9","11","1380","600","346","328","18","780","541","518","23","1380","40676","0.4936","39.8","2025","2854","2605","9","9","Jewell County, Kansas","20","089"
"514","265","26","13","3917","1196","667","627","40","2721","2069","1951","118","3917","53012","0.4242","39.8","4590","9445","8536","91","190","Rice County, Kansas","20","159"
"157","69","0","1","1771","608","308","297","11","1163","962","896","66","1771","49375","0.4456","41.9","2345","4064","3485","65","65","Stafford County, Kansas","20","185"
"928","244","9","4","6607","2160","1300","1291","9","4447","3463","3155","308","6607","54090","0.4246","39.2","7595","15655","14120","62","27","Osage County, Kansas","20","139"
"550","178","3","20","3585","1182","726","702","24","2403","2003","1779","224","3585","59583","0.4229","40.6","4102","8154","7481","24","7","Coffey County, Kansas","20","031"
"1682","1840","480","11","15284","4020","2315","2208","107","11264","8374","6937","1437","15284","41004","0.4629","37.7","18141","38330","33521","345","630","Crawford County, Kansas","20","037"
"220","30","8","7","2769","1046","633","608","25","1723","1195","1138","57","2769","41982","0.4585","42.2","4039","5984","5451","36","26","Greenwood County, Kansas","20","073"
"5164","1947","196","683","60758","18767","12336","11863","473","41991","35765","33344","2421","60758","96769","0.4003","38.9","63564","165607","155183","3788","1815","Carroll County, Maryland","24","013"
"2583","723","98","494","18577","6288","4310","4113","197","12289","10054","9415","639","18577","97034","0.4181","40.0","21184","49140","45191","988","580","Queen Anne's County, Maryland","24","035"
"4089","3680","535","945","40552","9677","6339","5975","364","30875","24330","22534","1796","40552","89845","0.4029","38.7","45109","109466","99247","2809","1794","St. Mary's County, Maryland","24","037"
"5200","3349","511","4579","56520","13731","9802","9354","448","42789","33853","31886","1967","56520","100003","0.3848","39.7","60452","156092","140986","5922","3267","Charles County, Maryland","24","017"
"938","398","26","112","13183","4713","2765","2607","158","8470","6428","5934","494","13183","52917","0.4710","39.2","16747","31732","29168","435","412","Dorchester County, Maryland","24","019"
"5422","2945","623","1117","56035","17770","10817","10284","533","38265","29745","27221","2524","56035","60860","0.4445","38.7","61506","141797","127746","3937","2077","Washington County, Maryland","24","043"
"3587","3436","536","333","37793","11384","7138","6563","575","26409","20572","17629","2943","37793","56956","0.4383","37.6","42382","101218","89159","2704","2670","Wicomico County, Maryland","24","045"
"2146","3561","289","707","37058","10531","7078","6658","420","26527","21251","19308","1943","37058","76887","0.4137","39.2","42658","101525","94494","1845","1047","Cecil County, Maryland","24","015"
"1261","384","49","116","12024","3630","2372","2264","108","8394","7030","6302","728","12024","58638","0.4462","39.3","13588","32682","29755","457","651","Caroline County, Maryland","24","011"
"32063","30540","14759","140557","309844","70584","36478","33822","2656","239260","163381","120139","43242","309844","69669","0.5327","38.5","337251","790089","541340","108286","110349","Suffolk County, Massachusetts","25","025"
"125","224","5","96","6765","2748","1678","1525","153","4017","2787","2468","319","6765","71811","0.4990","38.5","17902","17213","14794","915","598","Dukes County, Massachusetts","25","007"
"41262","41757","23803","109309","604384","169947","104851","99449","5402","434437","341538","291476","50062","604384","102603","0.4638","38.6","636543","1586008","1225311","165100","156196","Middlesex County, Massachusetts","25","017"
"13704","7440","2154","7733","217912","65539","39784","37460","2324","152373","117557","106233","11324","217912","69095","0.4579","37.5","235275","555111","472468","44859","22304","Bristol County, Massachusetts","25","005"
"7641","7176","2541","4249","179423","55773","32201","30105","2096","123650","92708","84082","8626","179423","55429","0.4731","37.2","193586","462644","410959","23673","13500","Hampden County, Massachusetts","25","013"
"17087","9697","6493","23035","294202","92683","56658","53425","3233","201519","156569","143010","13559","294202","79263","0.4816","37.7","312992","776718","627450","71122","54568","Essex County, Massachusetts","25","009"
"2280","919","249","799","30569","10686","6328","5771","557","19883","14475","11958","2517","30569","60950","0.4541","37.1","34134","69805","64994","1810","1554","Franklin County, Massachusetts","25","011"
"15742","12579","5704","8153","309951","88414","53252","50313","2939","221537","171198","152332","18866","309951","74679","0.4551","38.0","335104","813041","699546","52609","40562","Worcester County, Massachusetts","25","027"
"10820","5670","1890","2461","58838","19054","11809","11035","774","39784","29311","23675","5636","58838","70876","0.4532","34.1","63873","159678","142816","6320","6977","Hampshire County, Massachusetts","25","015"
"2016","545","123","49","13999","4610","2732","2564","168","9389","6720","5983","737","13999","46486","0.4752","37.3","21443","34630","31552","457","378","Chippewa County, Michigan","26","033"
"3528","2481","243","163","59929","18556","11694","11296","398","41373","31964","29668","2296","59929","62203","0.4203","39.0","64370","148820","139544","1929","1166","Monroe County, Michigan","26","115"
"38002","16870","11328","2624","504585","145484","87943","84297","3646","359101","266989","239261","27728","504585","79698","0.4687","39.1","539742","1246756","1042145","80236","69455","Oakland County, Michigan","26","125"
"1543","1233","45","47","18107","6004","3836","3606","230","12103","9179","8430","749","18107","49622","0.4339","38.5","21960","45328","41899","218","216","Hillsdale County, Michigan","26","059"
"7214","1841","356","339","65939","20199","12510","11911","599","45740","35777","32051","3726","65939","50854","0.4391","37.8","74092","168479","157440","1570","1158","Muskegon County, Michigan","26","121"
"953","533","43","57","9139","4337","2783","2709","74","4802","3817","3558","259","9139","65249","0.4569","37.7","15638","21495","19840","295","253","Leelanau County, Michigan","26","089"
"4017","578","183","157","33700","10576","7194","7013","181","23124","18711","17273","1438","33700","62641","0.4190","39.0","36674","86468","78595","826","782","Lapeer County, Michigan","26","087"
"1370","240","97","64","17499","5998","3733","3573","160","11501","8736","7945","791","17499","47672","0.4310","40.0","23086","40956","36715","295","294","Sanilac County, Michigan","26","151"
"129","32","4","1","1081","511","330","320","10","570","461","430","31","1081","50292","0.4572","36.7","2483","2106","1920","13","19","Keweenaw County, Michigan","26","083"
"59","89","13","12","2793","1400","889","816","73","1393","894","803","91","2793","41546","0.3986","36.2","5688","5821","5311","65","29","Ontonagon County, Michigan","26","131"
"16719","4459","807","1094","102610","28753","18114","17628","486","73857","61977","55695","6282","102610","69314","0.4163","37.3","109060","285197","260554","8304","5426","Ottawa County, Michigan","26","139"
"460","100","17","5","4988","2539","1587","1507","80","2449","1763","1562","201","4988","40484","0.4286","37.6","11188","10261","9684","70","32","Alcona County, Michigan","26","001"
"3333","303","47","124","22964","6420","4123","3912","211","16544","13299","12074","1225","22964","57043","0.3857","38.7","24967","60621","56187","522","300","Ionia County, Michigan","26","067"
"952","99","33","25","7145","2526","1611","1519","92","4619","3671","3318","353","7145","46898","0.4251","38.7","12370","17528","15672","89","62","Kalkaska County, Michigan","26","079"
"3235","4968","692","502","63665","21421","12892","12065","827","42244","31595","28793","2802","63665","50795","0.4842","38.0","77514","153075","135232","3358","3873","Berrien County, Michigan","26","021"
"1096","177","38","14","9184","3698","2368","2171","197","5486","4083","3696","387","9184","40373","0.4376","38.0","16192","20587","19043","119","93","Ogemaw County, Michigan","26","129"
"1884","430","36","63","12963","4390","2818","2708","110","8573","6699","6110","589","12963","47193","0.4537","38.5","16960","33062","30457","236","122","Wexford County, Michigan","26","165"
"742","188","42","27","6141","2400","1561","1491","70","3741","2915","2552","363","6141","47977","0.4154","38.0","11193","13708","12675","168","100","Crawford County, Michigan","26","039"
"393","349","7","13","11231","3866","2360","2258","102","7365","5430","4985","445","11231","51645","0.4356","38.3","14070","25131","23702","207","134","Dickinson County, Michigan","26","043"
"885","241","41","79","13847","5246","3092","2987","105","8601","6163","5685","478","13847","48289","0.4329","40.1","21281","30985","28684","275","163","Huron County, Michigan","26","063"
"22596","6904","2635","5031","112840","27932","15300","14468","832","84908","59028","46362","12666","112840","52872","0.4731","36.0","123570","288850","246862","10389","15521","Ingham County, Michigan","26","065"
"1128","311","60","15","12186","4669","2774","2665","109","7517","5709","5087","622","12186","51725","0.4634","38.3","17536","28669","26342","339","208","Mason County, Michigan","26","105"
"464","628","34","22","10627","3817","2170","2092","78","6810","4693","4249","444","10627","46828","0.4387","38.7","14342","22772","21485","148","83","Menominee County, Michigan","26","109"
"679","178","24","9","6055","2012","1312","1268","44","4043","3195","2895","300","6055","47194","0.3977","40.0","9227","14924","13542","58","62","Missaukee County, Michigan","26","113"
"1549","1493","53","167","24150","7597","4784","4502","282","16553","13021","11904","1117","24150","52086","0.4217","39.4","27920","60301","53800","583","884","St. Joseph County, Michigan","26","149"
"3353","1326","255","79","29411","9388","5964","5670","294","20023","15808","14710","1098","29411","54485","0.4391","39.1","37255","74775","66186","1074","1436","Van Buren County, Michigan","26","159"
"840","81","16","23","6571","2556","1594","1509","85","4015","2952","2642","310","6571","42290","0.4168","38.1","9836","14935","13867","121","50","Arenac County, Michigan","26","011"
"2221","473","152","57","24296","7534","4999","4623","376","16762","13591","12578","1013","24296","64490","0.4094","39.3","27586","60161","56757","475","429","Barry County, Michigan","26","015"
"167","201","3","6","5225","2249","1212","1141","71","2976","1998","1847","151","5225","41599","0.4293","38.6","9325","10861","9994","89","54","Iron County, Michigan","26","071"
"567","309","18","91","6792","2904","1992","1890","102","3888","2916","2636","280","6792","57974","0.4119","38.4","12524","17430","16186","239","82","Benzie County, Michigan","26","019"
"323","63","24","27","3468","1433","858","794","64","2035","1483","1370","113","3468","45500","0.4262","38.1","6385","7940","7442","28","5","Schoolcraft County, Michigan","26","153"
"34860","19453","8455","19651","682282","196649","111792","106114","5678","485633","338362","307216","31146","682282","47301","0.4978","38.2","815102","1744974","1499193","82617","53674","Wayne County, Michigan","26","163"
"4294","1735","86","587","37319","12046","7552","7105","447","25273","19608","17174","2434","37319","63575","0.4480","38.1","43942","90808","82897","1057","959","Grand Traverse County, Michigan","26","055"
"527","184","149","59","5269","2019","1323","1241","82","3250","2279","1931","348","5269","47938","0.4377","39.6","11168","10663","9339","101","117","Mackinac County, Michigan","26","097"
"9459","3992","689","2449","167902","51280","30320","28727","1593","116622","85549","77728","7821","167902","48588","0.4629","38.1","192290","405671","374096","6371","2936","Genesee County, Michigan","26","049"
"560","350","21","27","8176","2562","1463","1432","31","5614","4360","4146","214","8176","47643","0.4259","39.6","10058","19780","17506","70","31","Labette County, Kansas","20","099"
"9922","12845","2422","1372","197229","52075","30443","29425","1018","145154","105788","95600","10188","197229","56524","0.4525","39.0","219116","507552","422256","17169","13937","Sedgwick County, Kansas","20","173"
"63","103","0","6","2218","864","446","443","3","1354","937","901","36","2218","47976","0.4124","40.9","2873","4570","4294","22","21","Republic County, Kansas","20","157"
"55","28","0","2","1196","488","254","254","0","708","513","474","39","1196","46375","0.4035","40.0","1479","2490","2271","0","18","Graham County, Kansas","20","065"
"7550","5798","1435","1379","46936","9975","5977","5715","262","36961","27092","19640","7452","46936","59435","0.4741","35.9","50345","119524","103837","2743","4399","Douglas County, Kansas","20","045"
"100","68","49","0","1134","411","252","241","11","723","538","503","35","1134","62885","0.4401","43.3","1250","2477","2177","23","23","Sheridan County, Kansas","20","179"
"308","109","15","0","2151","563","303","296","7","1588","1333","1286","47","2151","64930","0.3890","41.4","2444","5954","4791","141","224","Gray County, Kansas","20","069"
"132","120","42","41","2700","587","392","375","17","2113","1631","1539","92","2700","24331","0.5473","39.6","3195","10135","6872","10","189","Todd County, South Dakota","46","121"
"161","154","0","61","2729","724","539","481","58","2005","1731","1696","35","2729","31997","0.5128","37.6","3646","14316","9052","28","9","Oglala Lakota County, South Dakota","46","102"
"430","850","87","43","8877","3422","2354","2139","215","5455","4006","3501","505","8877","55773","0.4544","39.1","10424","21679","18752","633","799","Klickitat County, Washington","53","039"
"4272","1592","91","267","28722","10716","6745","6360","385","18006","13415","11754","1661","28722","51240","0.4463","37.9","36273","69846","62352","1499","904","Grays Harbor County, Washington","53","027"
"146","56","0","22","1897","923","660","629","31","974","770","695","75","1897","53227","0.4427","39.3","2149","4225","3794","113","74","Wahkiakum County, Washington","53","069"
"3381","1647","467","260","30818","8945","5840","5400","440","21873","18093","16682","1411","30818","55556","0.4212","40.0","37476","94973","72895","3980","6068","Grant County, Washington","53","025"
"30611","17567","5485","22065","293823","74642","48076","45013","3063","219181","178439","158103","20336","293823","86691","0.4045","38.7","310127","788537","630734","63384","46581","Snohomish County, Washington","53","061"
"403","446","12","0","5566","2224","1257","1174","83","3342","2569","2512","57","5566","38187","0.4209","39.0","7705","11963","11522","30","19","Summers County, West Virginia","54","089"
"844","659","64","14","15188","5651","3350","3215","135","9537","6863","6153","710","15188","40200","0.4589","39.3","19270","34594","32454","178","188","Greenbrier County, West Virginia","54","025"
"340","540","3","102","10916","3918","2360","2301","59","6998","5333","4962","371","10916","49936","0.4147","38.5","13139","26941","25110","95","64","Mineral County, West Virginia","54","057"
"668","169","0","0","6574","2205","1538","1448","90","4369","3236","2927","309","6574","39908","0.4722","40.2","7966","15957","14855","42","33","Lewis County, West Virginia","54","041"
"162","192","4","17","3530","1509","844","815","29","2021","1497","1366","131","3530","41882","0.4773","39.2","8924","8169","7563","61","24","Pocahontas County, West Virginia","54","075"
"1314","458","12","21","11135","4163","2495","2432","63","6972","4983","4491","492","11135","43320","0.4935","39.0","14250","27139","24971","49","99","Randolph County, West Virginia","54","083"
"155","27","0","0","2505","903","532","510","22","1602","1235","1120","115","2505","46048","0.4002","40.7","3317","5798","5477","11","0","Wirt County, West Virginia","54","105"
"140","73","0","22","3274","1204","893","890","3","2070","1645","1398","247","3274","35024","0.4416","38.7","4638","8663","8359","0","0","Clay County, West Virginia","54","015"
"4823","6078","1090","1326","39466","8536","5268","5090","178","30930","20870","15645","5225","39466","52455","0.5257","37.1","44957","103950","93622","1733","3566","Monongalia County, West Virginia","54","061"
"369","234","20","5","5762","2420","1566","1481","85","3342","2552","2204","348","5762","43107","0.4204","39.2","8159","15335","14366","45","6","Wetzel County, West Virginia","54","103"
"4290","2601","365","1700","79070","26998","16012","15448","564","52072","36725","33050","3675","79070","46639","0.4837","39.1","92409","181327","167649","2021","1121","Kanawha County, West Virginia","54","039"
"770","807","166","61","12429","4487","2993","2746","247","7942","6416","5843","573","12429","51888","0.4291","39.5","15121","30800","28801","54","28","Preston County, West Virginia","54","077"
"497","173","2","9","4049","1568","908","885","23","2481","2049","1917","132","4049","43577","0.4725","40.6","5898","9791","8838","49","56","Ritchie County, West Virginia","54","085"
"143","214","34","24","8208","2860","1903","1883","20","5348","4280","4038","242","8208","42345","0.4481","39.2","9937","20791","19484","9","24","Lincoln County, West Virginia","54","043"
"541","115","8","0","5624","2150","1571","1472","99","3474","2746","2605","141","5624","41466","0.4375","40.2","7426","13834","13076","0","6","Braxton County, West Virginia","54","007"
"468","199","17","0","8932","3127","2094","1953","141","5805","4571","4194","377","8932","40739","0.4386","41.4","11199","22246","20926","45","13","Boone County, West Virginia","54","005"
"229","95","0","28","8805","3278","2366","2319","47","5527","4484","4296","188","8805","42332","0.4520","40.9","10904","21205","19933","69","24","Wyoming County, West Virginia","54","109"
"2931","2088","57","24","16859","4786","2791","2609","182","12073","9282","7760","1522","16859","58783","0.4171","36.9","18463","44412","40850","448","568","Dunn County, Wisconsin","55","033"
"2941","1165","69","59","19583","5742","3284","3128","156","13841","10804","8911","1893","19583","54800","0.4089","38.7","22076","50596","46801","310","372","Grant County, Wisconsin","55","043"
"2186","1275","345","197","47738","14343","8324","7949","375","33395","25075","22756","2319","47738","60696","0.4092","39.0","51075","112935","102704","3931","1759","Sheboygan County, Wisconsin","55","117"
"187","5","0","33","1408","473","334","321","13","935","777","718","59","1408","40921","0.5069","35.2","2361","4527","3398","0","7","Menominee County, Wisconsin","55","078"
"581","257","6","11","5772","1966","1242","1164","78","3806","2956","2647","309","5772","57829","0.4097","40.5","6788","13055","12254","75","44","Buffalo County, Wisconsin","55","011"
"6169","3263","199","505","47518","13031","7580","7240","340","34487","25608","20262","5346","47518","57882","0.4551","37.1","50304","116551","108024","2493","987","La Crosse County, Wisconsin","55","063"
"4222","1708","325","291","55466","16256","10147","9601","546","39210","30769","27528","3241","55466","62633","0.4412","39.6","59335","134385","122188","2905","1319","Marathon County, Wisconsin","55","073"
"1123","325","26","20","12005","3610","2104","1975","129","8395","6407","5713","694","12005","58548","0.3993","40.7","13138","29128","26375","343","293","Trempealeau County, Wisconsin","55","121"
"4193","1053","236","49","34980","10160","6089","5718","371","24820","19286","17320","1966","34980","60652","0.3967","39.6","37805","83913","79421","665","705","Dodge County, Wisconsin","55","027"
"740","451","5","6","10921","4642","2904","2757","147","6279","4597","4141","456","10921","47072","0.4776","38.1","25921","21549","19865","227","96","Vilas County, Wisconsin","55","125"
"1507","845","184","229","34563","10831","6015","5762","253","23732","17585","15780","1805","34563","56612","0.4041","39.6","37486","78768","73726","988","702","Manitowoc County, Wisconsin","55","071"
"288","532","10","20","7305","2948","1967","1843","124","4357","3284","2912","372","7305","52672","0.4193","38.1","15597","15183","13980","117","45","Burnett County, Wisconsin","55","013"
"782","588","99","57","13191","5396","3547","3447","100","7795","6184","5634","550","13191","61560","0.4390","39.5","24857","27134","25426","383","281","Door County, Wisconsin","55","029"
"4469","1140","366","115","41542","12471","7336","6923","413","29071","22427","20308","2119","41542","62391","0.4101","39.1","45206","100864","94047","939","1910","Fond du Lac County, Wisconsin","55","039"
"161","91","14","2","3070","1092","637","599","38","1978","1515","1404","111","3070","54583","0.4238","40.8","3663","7191","6572","40","23","Pepin County, Wisconsin","55","091"
"665","209","118","66","7538","2692","1633","1518","115","4846","3681","3289","392","7538","51947","0.4133","39.6","8982","17324","15696","141","73","Richland County, Wisconsin","55","103"
"1297","363","17","4","9934","3888","2470","2355","115","6046","4658","4370","288","9934","52810","0.4311","39.3","15113","22954","20791","285","169","Waushara County, Wisconsin","55","137"
"670","170","7","8","6722","2122","1274","1228","46","4600","3671","3321","350","6722","60691","0.4042","42.1","7310","16631","14926","50","171","Lafayette County, Wisconsin","55","065"
"2254","2712","271","32","15593","4126","2708","2601","107","11467","8992","7555","1437","15593","72323","0.3938","37.4","16599","41687","39038","226","495","Pierce County, Wisconsin","55","093"
"1994","338","98","85","19807","4957","3138","3032","106","14850","12363","11627","736","19807","75814","0.3983","39.7","20712","49764","47145","818","178","Calumet County, Wisconsin","55","015"
"3870","6520","511","1025","64111","16361","9339","8949","390","47750","37089","32907","4182","64111","63733","0.4355","38.4","70441","166531","147567","5119","3178","Kenosha County, Wisconsin","55","059"
"214","347","33","14","3845","1367","910","886","24","2478","1697","1613","84","3845","58132","0.4950","44.0","4620","8393","7233","26","41","Johnson County, Wyoming","56","019"
"47","11","2","4","636","244","146","146","0","392","308","306","2","636","63269","0.3566","44.0","781","1549","1423","32","2","Wallace County, Kansas","20","199"
"132","5","6","0","1051","445","232","220","12","606","456","434","22","1051","45353","0.4056","38.1","1494","2548","2242","22","19","Chase County, Kansas","20","017"
"88","344","0","0","1814","541","344","314","30","1273","1085","1022","63","1814","57806","0.4621","42.1","2329","5480","3991","149","341","Stevens County, Kansas","20","189"
"157","35","3","1","1701","656","380","375","5","1045","830","737","93","1701","43429","0.4458","39.7","2244","3567","3226","6","29","Smith County, Kansas","20","183"
"111","124","0","16","2551","665","442","442","0","1886","1488","1365","123","2551","53413","0.4129","41.9","2961","7345","5600","300","324","Grant County, Kansas","20","067"
"1234","333","53","43","9899","4164","2901","2794","107","5735","4554","4135","419","9899","56165","0.4561","38.7","18069","23031","21301","219","102","Antrim County, Michigan","26","009"
"1884","1053","366","34","13386","4202","2354","2310","44","9184","6398","5088","1310","13386","43183","0.4736","35.2","18798","35650","31734","450","953","Houghton County, Michigan","26","061"
"6625","1891","326","261","72000","21463","14497","13915","582","50537","41314","38238","3076","72000","84221","0.4071","39.1","76321","188829","177087","3324","1599","Livingston County, Michigan","26","093"
"895","676","65","17","11669","5175","3171","2912","259","6494","4649","4162","487","11669","43678","0.4112","38.3","20558","24874","22762","259","208","Iosco County, Michigan","26","069"
"841","149","9","23","4631","2164","1329","1232","97","2467","1689","1492","197","4631","37320","0.4322","37.7","15347","11541","10644","87","86","Lake County, Michigan","26","085"
"1204","451","77","104","9426","4134","2542","2443","99","5292","3813","3513","300","9426","50055","0.4365","37.8","15848","23218","21534","146","187","Manistee County, Michigan","26","101"
"605","174","24","13","5465","1724","1162","1142","20","3741","2884","2647","237","5465","57914","0.3962","38.9","5859","13128","12261","86","40","Jackson County, Kansas","20","085"
"270","131","3","1","3133","1151","587","576","11","1982","1620","1559","61","3133","60469","0.4417","40.4","3847","7218","6728","23","55","Kingman County, Kansas","20","095"
"117","71","0","0","1153","368","220","220","0","785","562","528","34","1153","51740","0.4407","41.0","1442","2765","2524","18","39","Logan County, Kansas","20","109"
"430","75","9","39","4007","1262","737","716","21","2745","2162","2022","140","4007","63216","0.4073","39.3","4600","9847","9301","43","18","Nemaha County, Kansas","20","131"
"1398","718","32","1","8698","2248","1414","1402","12","6450","5211","4952","259","8698","66835","0.3979","40.0","9649","23357","21802","145","228","Pottawatomie County, Kansas","20","149"
"5140","5333","747","719","60128","14415","8492","8051","441","45713","33287","30168","3119","60128","46881","0.4246","39.0","68095","163593","120641","4791","8652","Wyandotte County, Kansas","20","209"
"399","720","8","1","7929","2721","1420","1375","45","5208","4102","3809","293","7929","43175","0.4102","39.0","9875","19992","17506","62","129","Cherokee County, Kansas","20","021"
"2891","1257","200","65","24870","7141","4074","3949","125","17729","14813","13935","878","24870","64782","0.4158","38.8","26918","64098","57471","868","595","Butler County, Kansas","20","015"
"519","121","22","4","3514","1247","715","687","28","2267","1631","1585","46","3514","53929","0.4453","39.4","4101","7863","7166","89","37","Clay County, Kansas","20","027"
"165","25","0","1","1248","447","253","240","13","801","534","500","34","1248","45076","0.3977","41.3","1853","2982","2712","2","8","Lincoln County, Kansas","20","105"
"2053","1505","438","238","21959","6449","3610","3404","206","15510","11151","9954","1197","21959","52200","0.4370","39.3","24377","53934","46990","1171","1082","Saline County, Kansas","20","169"
"961","452","44","0","9416","3164","1700","1600","100","6252","4933","4571","362","9416","55000","0.4151","39.8","10993","22637","20617","160","103","Sumner County, Kansas","20","191"
"356","26","8","3","1379","464","297","281","16","915","612","599","13","1379","57966","0.3718","43.9","1669","2753","2480","48","0","Trego County, Kansas","20","195"
"377","65","8","2","2744","974","556","542","14","1770","1403","1332","71","2744","61178","0.3684","38.9","3294","6787","6359","64","19","Wabaunsee County, Kansas","20","197"
"400","79","0","19","3712","1344","708","690","18","2368","1840","1684","156","3712","48341","0.4839","38.3","4682","8549","7864","64","23","Wilson County, Kansas","20","205"
"289","98","7","0","2570","904","514","453","61","1666","1232","1101","131","2570","46203","0.4384","40.5","3292","5999","5480","37","15","Mitchell County, Kansas","20","123"
"109","65","2","4","1648","571","301","298","3","1077","749","659","90","1648","51286","0.4775","42.2","2180","3430","3129","24","7","Osborne County, Kansas","20","141"
"465","589","0","1","5958","1936","1025","960","65","4022","3042","2901","141","5958","50439","0.4209","35.3","6961","16091","14866","77","77","Atchison County, Kansas","20","005"
"812","840","63","111","12519","2846","1667","1581","86","9673","7823","7298","525","12519","60798","0.3884","40.4","13562","36494","25747","2885","3267","Finney County, Kansas","20","055"
"28","121","22","0","890","212","136","119","17","678","432","422","10","890","46944","0.3439","45.6","1215","2591","1950","66","80","Hamilton County, Kansas","20","075"
"3795","5997","627","77","27253","7618","4961","4794","167","19635","15495","14775","720","27253","73013","0.4144","39.0","29771","73546","68353","1028","671","Leavenworth County, Kansas","20","103"
"95","69","3","2","2332","835","478","466","12","1497","1078","999","79","2332","50588","0.4182","42.1","2932","5364","5021","34","68","Washington County, Kansas","20","201"
"31","25","33","0","934","260","145","145","0","674","508","483","25","934","57978","0.3615","43.0","1102","2100","1760","54","153","Wichita County, Kansas","20","203"
"22","48","9","0","1038","357","216","216","0","681","484","406","78","1038","47750","0.4193","41.2","1461","2677","1991","119","138","Morton County, Kansas","20","129"
"529","140","0","0","1830","732","353","314","39","1098","887","823","64","1830","49038","0.4589","37.7","2542","4592","4230","1","19","Norton County, Kansas","20","137"
"984","269","210","93","10624","3329","1958","1887","71","7295","5402","4869","533","10624","49723","0.4369","40.3","12733","26071","22234","290","489","Barton County, Kansas","20","009"
"466","226","8","19","3689","1183","692","661","31","2506","1872","1688","184","3689","45373","0.4440","40.7","4605","8696","7746","79","41","Cloud County, Kansas","20","029"
"70","16","0","0","1308","426","227","219","8","882","644","621","23","1308","50902","0.3881","43.5","1618","2780","2352","87","157","Edwards County, Kansas","20","047"
"48","7","0","0","757","206","122","120","2","551","311","282","29","757","52125","0.4271","42.9","970","1559","1364","11","6","Lane County, Kansas","20","101"
"123","26","5","3","1421","531","246","237","9","890","586","526","60","1421","47981","0.4011","42.3","1858","2951","2774","14","3","Rush County, Kansas","20","165"
"357","145","36","5","4846","1822","1060","1028","32","3024","2399","2170","229","4846","52123","0.4095","39.3","6000","11603","10760","72","25","Marion County, Kansas","20","115"
"692","174","39","13","6601","2185","1183","1160","23","4416","3362","3188","174","6601","46291","0.4367","39.0","7744","15918","13909","58","24","Neosho County, Kansas","20","133"
"174","51","27","9","2446","786","484","480","4","1660","1346","1230","116","2446","54784","0.4098","40.9","2788","5732","5317","25","35","Ottawa County, Kansas","20","143"
"5753","3700","1922","183","26490","4435","2675","2612","63","22055","15438","11195","4243","26490","51208","0.4747","37.8","30912","68256","58968","1516","3736","Riley County, Kansas","20","161"
"120","114","5","8","1923","691","434","411","23","1232","859","778","81","1923","50174","0.4708","40.5","2801","4582","4058","13","40","Barber County, Kansas","20","007"
"674","577","118","26","7911","2512","1377","1286","91","5399","3919","3709","210","7911","49991","0.4398","39.6","9172","18494","16835","159","75","Dickinson County, Kansas","20","041"
"690","177","7","0","7575","2241","1410","1369","41","5334","4438","4040","398","7575","64864","0.3662","39.2","8378","18645","17438","39","48","Jefferson County, Kansas","20","087"
"1314","740","24","39","14056","4947","3185","3079","106","9109","7719","7067","652","14056","51655","0.4622","39.1","16319","35132","33175","169","79","Greenup County, Kentucky","21","089"
"526","98","21","10","5841","1850","1065","989","76","3991","3367","3211","156","5841","44612","0.4549","40.2","6705","14513","13143","29","24","Fleming County, Kentucky","21","069"
"638","358","163","17","9606","3458","1983","1947","36","6148","4867","4657","210","9606","34736","0.4991","37.2","12503","26838","24599","12","69","Carter County, Kentucky","21","043"
"1307","398","23","14","9141","2477","1539","1491","48","6664","5664","5266","398","9141","48714","0.4284","39.8","10209","24530","22997","318","11","Grant County, Kentucky","21","081"
"13917","17269","2554","10281","312679","87556","50530","47925","2605","225123","157330","138012","19318","312679","56586","0.4755","38.8","345261","759033","670038","24798","24504","Jefferson County, Kentucky","21","111"
"714","602","38","11","10418","3347","2044","1976","68","7071","5537","5105","432","10418","48014","0.4432","39.9","12363","26563","24422","175","90","Logan County, Kentucky","21","141"
"524","602","252","23","6700","2098","1255","1228","27","4602","3454","3227","227","6700","45377","0.5178","39.3","8163","16801","15292","72","108","Mason County, Kentucky","21","161"
"844","170","0","42","5253","1544","956","923","33","3709","2959","2852","107","5253","54375","0.4250","39.5","6361","14473","13967","84","70","Pendleton County, Kentucky","21","191"
"77","60","0","0","861","276","147","142","5","585","423","352","71","861","41902","0.4680","38.9","1080","2059","1897","0","0","Robertson County, Kentucky","21","201"
"881","262","55","5","6763","1649","1213","1169","44","5114","4555","4295","260","6763","80166","0.3922","39.4","7273","18553","17726","69","55","Spencer County, Kentucky","21","215"
"376","218","52","0","4827","1450","967","910","57","3377","2839","2613","226","4827","44898","0.4284","39.6","5496","12281","11550","17","27","Bath County, Kentucky","21","011"
"171","248","3","56","3065","1119","688","664","24","1946","1561","1455","106","3065","45048","0.4549","37.9","3917","7913","7174","110","26","Ballard County, Kentucky","21","007"
"2266","993","146","46","11023","3747","2010","1920","90","7276","5488","5091","397","11023","46382","0.4771","38.9","12490","28528","26684","248","296","Boyle County, Kentucky","21","021"
"616","43","0","37","4413","1597","912","895","17","2816","2162","2020","142","4413","35899","0.4842","39.0","5304","10855","10170","19","45","Green County, Kentucky","21","087"
"607","173","20","43","11134","3621","2169","2112","57","7513","5701","5335","366","11134","26478","0.4919","38.9","13589","26219","24556","76","60","Harlan County, Kentucky","21","095"
"528","410","22","0","4153","1480","946","923","23","2673","2117","1882","235","4153","41013","0.4244","40.0","5280","10377","9731","3","0","Martin County, Kentucky","21","159"
"1538","71","19","42","9697","3221","1996","1878","118","6476","5254","4902","352","9697","42919","0.4271","39.8","11015","24219","21934","28","34","Lincoln County, Kentucky","21","137"
"238","84","33","34","4491","1486","709","698","11","3005","2310","2143","167","4491","34879","0.5106","39.0","5260","10495","9437","38","95","Monroe County, Kentucky","21","171"
"672","262","25","0","9122","2882","1905","1844","61","6240","5117","4679","438","9122","45564","0.4703","39.6","10386","23716","22177","110","125","Ohio County, Kentucky","21","183"
"313","1088","4","0","5374","1604","1088","1079","9","3770","2877","2724","153","5374","46673","0.4122","41.6","6249","14470","13618","58","99","Union County, Kentucky","21","225"
"459","151","39","5","4953","1533","847","810","37","3420","2604","2504","100","4953","42119","0.4697","40.1","5960","12724","11619","114","208","Webster County, Kentucky","21","233"
"1128","116","235","0","12987","4082","2823","2727","96","8905","7060","6529","531","12987","41505","0.4945","40.4","16365","40584","31792","880","502","Jim Wells County, Texas","48","249"
"247","273","302","0","2364","555","376","370","6","1809","1495","1341","154","2364","58811","0.4676","44.1","2955","7262","4539","272","230","Dallam County, Texas","48","111"
"444","219","16","3","4452","2043","1351","1292","59","2409","1674","1498","176","4452","41772","0.3887","39.5","9615","9179","8381","64","25","Montmorency County, Michigan","26","119"
"373","167","15","4","5797","2648","1798","1719","79","3149","2306","2143","163","5797","47948","0.4352","40.0","10474","12589","11571","100","45","Presque Isle County, Michigan","26","141"
"1034","187","21","52","11047","4541","2925","2776","149","6506","4690","4309","381","11047","44619","0.4472","37.5","17923","25120","22556","198","39","Gladwin County, Michigan","26","051"
"12872","6008","1732","2221","103445","27146","15372","14639","733","76299","56483","46635","9848","103445","56511","0.4672","37.3","112108","260675","234117","5410","6970","Kalamazoo County, Michigan","26","077"
"3696","439","144","88","15808","5257","3329","3117","212","10551","7763","6477","1286","15808","45018","0.4555","36.3","21539","43013","39437","281","451","Mecosta County, Michigan","26","107"
"3082","1369","179","132","26552","8488","5285","5040","245","18064","13258","10842","2416","26552","53970","0.4284","36.2","34850","64947","61137","690","428","Marquette County, Michigan","26","103"
"1954","429","48","104","19161","6200","3982","3782","200","12961","10120","9300","820","19161","50326","0.4368","38.8","25529","47829","43998","417","396","Newaygo County, Michigan","26","123"
"990","371","26","50","9181","3265","2147","2054","93","5916","4396","4089","307","9181","44032","0.4215","39.5","13784","22977","20571","146","46","Osceola County, Michigan","26","133"
"1458","205","18","27","9944","3393","2192","2127","65","6551","5261","4710","551","9944","54332","0.4089","38.5","14899","24303","22320","315","50","Otsego County, Michigan","26","137"
"4496","1897","351","582","53991","16302","9533","8921","612","37689","27096","24850","2246","53991","48607","0.4437","38.4","60889","132568","120676","2111","2449","Calhoun County, Michigan","26","025"
"1164","395","25","91","11195","4702","3016","2835","181","6493","4903","4470","433","11195","48044","0.4211","38.5","18512","25078","22975","220","82","Cheboygan County, Michigan","26","031"
"489","81","14","0","2231","872","527","495","32","1359","1002","932","70","2231","45469","0.3958","36.7","4373","5292","4988","22","32","Luce County, Michigan","26","095"
"21608","10037","2900","6252","241746","60311","36179","34704","1475","181435","142545","125452","17093","241746","63053","0.4569","38.2","255024","643646","562110","20351","23676","Kent County, Michigan","26","081"
"6401","1463","405","367","78933","25355","14770","14039","731","53578","39998","35710","4288","78933","48000","0.4770","37.7","87665","188503","176040","2252","1733","Saginaw County, Michigan","26","145"
"2518","383","39","72","27593","8561","5259","4975","284","19032","15372","13834","1538","27593","56032","0.4036","39.0","30224","67937","64040","347","270","Shiawassee County, Michigan","26","155"
"3265","712","159","272","44339","14232","8220","7809","411","30107","22515","20251","2264","44339","48819","0.4349","38.0","48289","103211","96599","827","515","Bay County, Michigan","26","017"
"1209","277","20","116","11503","4231","2749","2632","117","7272","5340","4819","521","11503","55760","0.4640","38.2","17678","25935","23828","222","144","Charlevoix County, Michigan","26","029"
"1003","495","68","131","16234","6015","3677","3495","182","10219","7770","7006","764","16234","47434","0.4362","37.4","20367","35643","33238","240","91","Delta County, Michigan","26","041"
"1450","487","43","49","14463","4838","3118","2998","120","9625","6894","6129","765","14463","55829","0.4656","38.8","21678","32780","29936","358","188","Emmet County, Michigan","26","047"
"254","346","21","25","5538","2024","1223","1155","68","3514","2493","2289","204","5538","50870","0.4302","37.3","7937","12329","11193","430","303","Koochiching County, Minnesota","27","071"
"1363","217","33","97","13371","4244","2448","2345","103","9127","7197","6676","521","13371","57815","0.4276","39.7","16150","32719","30827","209","89","Morrison County, Minnesota","27","097"
"525","161","7","43","5995","1850","976","902","74","4145","3013","2664","349","5995","60122","0.4033","39.7","6542","13971","13325","181","121","Pennington County, Minnesota","27","113"
"1550","807","21","157","14692","4304","2584","2515","69","10388","7908","7284","624","14692","64903","0.4088","39.3","15628","36295","33457","929","768","Steele County, Minnesota","27","147"
"99","173","3","29","2818","824","414","404","10","1994","1488","1429","59","2818","60595","0.4312","39.9","3117","6165","5999","22","2","Wilkin County, Minnesota","27","167"
"709","119","19","21","7681","3518","2260","2140","120","4163","3048","2789","259","7681","49351","0.4254","39.0","16743","15651","14835","127","51","Aitkin County, Minnesota","27","001"
"514","87","23","5","6137","2167","1210","1148","62","3970","2896","2654","242","6137","53156","0.4295","39.0","7043","13521","12695","98","71","Faribault County, Minnesota","27","043"
"276","111","7","9","3645","1437","821","801","20","2208","1686","1558","128","3645","60231","0.4043","40.7","4627","8197","7619","71","179","Murray County, Minnesota","27","101"
"1170","730","119","292","16889","4994","3109","3022","87","11895","9269","8374","895","16889","60294","0.4348","39.0","19917","42141","36680","1084","1606","Kandiyohi County, Minnesota","27","067"
"355","128","3","32","5192","1850","1106","1061","45","3342","2408","2241","167","5192","61452","0.3880","38.1","7775","10391","9824","95","37","Lake County, Minnesota","27","075"
"264","421","2","14","3914","1172","699","692","7","2742","2200","2016","184","3914","63005","0.4168","40.1","4267","9175","8674","87","30","Rock County, Minnesota","27","133"
"290","216","20","39","5980","1722","1088","1057","31","4258","3265","2947","318","5980","62202","0.3970","38.8","7607","15183","14043","369","185","Roseau County, Minnesota","27","135"
"93","122","3","8","1608","555","313","307","6","1053","762","709","53","1608","51957","0.4088","39.8","2065","3225","3083","39","8","Traverse County, Minnesota","27","155"
"1006","715","99","89","13617","4566","2948","2812","136","9051","6947","6509","438","13617","60284","0.4489","39.0","19704","33609","31098","261","132","Becker County, Minnesota","27","005"
"41224","31508","10068","48634","508030","121568","67570","63281","4289","386462","272965","228429","44536","508030","78167","0.4817","38.4","533880","1237371","1026029","83226","67998","Hennepin County, Minnesota","27","053"
"554","422","27","45","10764","3592","2143","2042","101","7172","5489","4962","527","10764","61120","0.3956","38.8","11729","24835","23409","263","262","Brown County, Minnesota","27","015"
"526","263","10","45","5209","1708","939","899","40","3501","2553","2348","205","5209","55269","0.4310","40.6","5713","11760","10440","91","315","Chippewa County, Minnesota","27","023"
"332","102","28","18","3405","1218","709","689","20","2187","1675","1549","126","3405","50386","0.4577","40.1","4790","8713","7893","37","30","Clearwater County, Minnesota","27","029"
"2000","846","147","359","19452","6109","3586","3383","203","13343","10458","9424","1034","19452","66800","0.4139","39.4","20616","45408","42141","488","530","Goodhue County, Minnesota","27","049"
"2878","451","36","91","14903","4203","2796","2606","190","10700","8590","7573","1017","14903","74616","0.3946","38.9","16007","39113","36928","428","122","Isanti County, Minnesota","27","059"
"366","164","34","13","4419","1478","859","832","27","2941","2313","2030","283","4419","58727","0.4378","39.4","5077","9842","9192","155","142","Jackson County, Minnesota","27","063"
"1521","951","304","353","15565","4936","2759","2633","126","10629","8081","7363","718","15565","54295","0.4500","38.7","17071","39323","33431","1056","2266","Mower County, Minnesota","27","099"
"1263","374","20","39","10760","4003","2452","2276","176","6757","4982","4528","454","10760","53422","0.4276","37.4","17596","27679","25786","205","68","Pine County, Minnesota","27","115"
"4405","4240","1501","4033","62108","15997","9790","9441","349","46111","34897","31020","3877","62108","76951","0.4505","38.9","65380","153048","131612","7836","7703","Olmsted County, Minnesota","27","109"
"603","147","18","7","5666","1897","1105","1042","63","3769","2840","2499","341","5666","46605","0.4118","37.9","7134","13332","12319","62","45","Wadena County, Minnesota","27","159"
"3250","619","84","256","16452","3641","2159","2096","63","12811","9715","8268","1447","16452","57715","0.4091","39.4","17093","39604","36810","700","706","Benton County, Minnesota","27","009"
"857","336","112","85","13009","4510","2766","2606","160","8499","6514","5873","641","13009","53631","0.4141","39.0","14357","30015","27297","451","680","Freeborn County, Minnesota","27","047"
"1625","380","33","152","19506","7263","4303","4070","233","12243","9654","8673","981","19506","55139","0.4308","38.0","27667","44359","41554","280","156","Itasca County, Minnesota","27","061"
"614","74","10","7","4981","1783","1040","998","42","3198","2470","2228","242","4981","61275","0.4163","40.9","6613","10872","10366","39","71","Pope County, Minnesota","27","121"
"581","329","120","93","3624","1088","638","620","18","2536","1886","1522","364","3624","60559","0.4854","37.8","4214","9696","8885","200","400","Stevens County, Minnesota","27","149"
"533","47","52","15","4263","1457","744","723","21","2806","2082","1953","129","4263","51620","0.4587","39.4","4843","9234","8712","29","104","Swift County, Minnesota","27","151"
"399","276","71","31","4846","1793","958","940","18","3053","2315","2187","128","4846","52087","0.3933","39.0","5423","11127","9980","202","351","Cottonwood County, Minnesota","27","033"
"7362","1658","613","1562","49479","10294","6796","6551","245","39185","33619","31446","2173","49479","102152","0.4009","38.8","51213","143534","126234","8210","3763","Scott County, Minnesota","27","139"
"771","370","60","230","9020","3042","1885","1775","110","5978","4779","4290","489","9020","65226","0.4161","40.4","10241","21362","20029","175","45","Wabasha County, Minnesota","27","157"
"266","384","50","0","3973","1272","646","633","13","2701","2013","1814","199","3973","52917","0.4643","40.2","4500","9032","8054","68","308","Pipestone County, Minnesota","27","117"
"115","263","16","21","2746","933","556","535","21","1813","1319","1174","145","2746","55085","0.4411","40.3","3429","6384","5913","19","67","Norman County, Minnesota","27","107"
"2695","446","60","68","12885","3622","2122","1990","132","9263","7243","6611","632","12885","67399","0.4215","35.8","13535","33722","31489","618","507","Nicollet County, Minnesota","27","103"
"32650","12062","11047","5656","237883","55396","43147","42109","1038","182487","159292","153620","5672","237883","97743","0.4343","39.6","251641","760164","491607","108397","71507","Fort Bend County, Texas","48","157"
"254","0","0","7","682","191","115","115","0","491","344","330","14","682","47500","0.4465","46.5","909","1604","1320","41","7","Irion County, Texas","48","235"
"1116","80","111","0","5782","2014","1533","1483","50","3768","3210","3041","169","5782","35521","0.4650","39.3","7323","20335","13142","858","729","Willacy County, Texas","48","489"
"1135","107","70","0","4322","1374","854","790","64","2948","2255","2099","156","4322","43239","0.4971","41.0","5187","11065","8822","277","127","Dawson County, Texas","48","115"
"850","168","125","25","6810","2440","1651","1624","27","4370","3379","3128","251","6810","57731","0.4377","41.2","9203","17888","14647","269","253","Burleson County, Texas","48","051"
"13366","6972","1067","1954","129451","36042","24115","22991","1124","93409","71659","64552","7107","129451","55919","0.4590","40.4","149287","356637","275469","9906","10428","Nueces County, Texas","48","355"
"558","55","54","0","4330","1841","1186","1125","61","2489","2023","1937","86","4330","51579","0.4560","40.3","5398","11703","9098","127","204","Rains County, Texas","48","379"
"256","30","0","0","1126","621","400","392","8","505","308","283","25","1126","35862","0.4533","39.4","2613","3308","2416","13","0","Real County, Texas","48","385"
"35","0","0","0","458","94","57","52","5","364","310","305","5","458","59868","0.3390","46.5","592","1194","856","21","43","Sterling County, Texas","48","431"
"508","197","0","0","2288","763","462","450","12","1525","1194","1152","42","2288","74872","0.4019","43.5","2796","5972","5284","53","44","Carson County, Texas","48","065"
"1511","73","18","4","6758","2520","1449","1414","35","4238","3430","3263","167","6758","49471","0.4663","42.6","9495","18047","14910","363","221","Freestone County, Texas","48","161"
"305","22","19","0","1596","642","386","341","45","954","769","713","56","1596","41859","0.4485","42.1","2344","3935","3294","22","74","Hardeman County, Texas","48","197"
"97","42","0","0","602","254","148","136","12","348","268","238","30","602","40227","0.4273","40.5","997","1457","1064","21","35","Briscoe County, Texas","48","045"
"9595","850","62","98","26873","7964","5119","4963","156","18909","15044","14351","693","26873","51494","0.4434","42.2","31362","76291","57691","1715","1783","Liberty County, Texas","48","291"
"0","0","0","0","30","15","9","7","2","15","13","13","0","30","83750","0.4906","","66","98","74","0","12","Loving County, Texas","48","301"
"1048","139","62","4","6444","2206","1497","1447","50","4238","3345","3126","219","6444","52928","0.4467","38.2","8855","16796","13765","287","516","Robertson County, Texas","48","395"
"6650","437","82","52","18108","6108","4056","3907","149","12000","9835","9163","672","18108","55234","0.4529","41.8","21715","48945","38428","578","946","Rusk County, Texas","48","401"
"930","123","6","41","6030","2631","1769","1707","62","3399","2567","2411","156","6030","41357","0.4689","42.2","9011","14466","11350","64","179","Trinity County, Texas","48","455"
"2098","133","31","6","8399","3924","2779","2746","33","4475","3428","3106","322","8399","58661","0.4210","38.4","11930","22036","17664","288","275","Bandera County, Texas","48","019"
"486","74","0","0","2407","723","348","344","4","1684","1272","1203","69","2407","43181","0.4419","41.6","2910","5747","4419","119","168","Childress County, Texas","48","075"
"9828","3045","473","157","51367","16506","11762","11443","319","34861","28409","26787","1622","51367","79936","0.4381","40.2","58181","140424","118568","3123","2612","Comal County, Texas","48","091"
"1042","79","42","0","8252","3384","2086","2023","63","4868","3643","3396","247","8252","37904","0.4579","41.2","11764","19877","16595","155","164","Houston County, Texas","48","225"
"2253","497","223","76","17338","5515","3775","3554","221","11823","9384","8793","591","17338","48529","0.4553","40.2","20938","48192","35763","1635","1903","Navarro County, Texas","48","349"
"934","103","33","0","5941","1796","1012","1012","0","4145","3202","2992","210","5941","54326","0.4133","40.7","7217","15590","12045","193","402","Scurry County, Texas","48","415"
"77","4","19","0","580","204","101","101","0","376","273","273","0","580","51250","0.4414","43.5","930","1427","1200","11","16","Stonewall County, Texas","48","433"
"5492","1559","293","43","25571","7751","5290","4977","313","17820","14428","13629","799","25571","64597","0.4320","39.7","30035","82357","63653","2019","3235","Bastrop County, Texas","48","021"
"2899","171","47","0","8269","2533","1591","1544","47","5736","4584","4208","376","8269","44578","0.4868","38.6","10739","24977","19727","340","120","Bee County, Texas","48","025"
"110","0","28","40","1421","371","249","236","13","1050","914","898","16","1421","65969","0.4048","41.7","1681","4706","3412","309","276","Crane County, Texas","48","103"
"627","1471","91","264","25338","8880","5105","4744","361","16458","11526","9993","1533","25338","56139","0.4368","38.7","34411","58308","54156","933","519","Rutland County, Vermont","50","021"
"781","804","107","78","12279","4243","2606","2419","187","8036","6037","5257","780","12279","60925","0.4005","39.0","15417","28823","26885","380","188","Orange County, Vermont","50","017"
"1039","1978","193","252","24298","8912","5332","4971","361","15386","11100","9642","1458","24298","60987","0.4571","38.4","34882","54560","50062","1014","881","Windsor County, Vermont","50","027"
"18302","25574","6679","6187","165991","30971","23276","22828","448","135020","122985","112123","10862","165991","74665","0.4189","35.1","174162","602118","522009","15124","16560","Utah County, Utah","49","049"
"1010","367","13","30","6868","1547","1114","1081","33","5321","4480","4246","234","6868","63224","0.3931","40.4","10282","19787","16727","235","151","Duchesne County, Utah","49","013"
"964","1073","66","54","10569","2411","1549","1541","8","8158","6522","6114","408","10569","65264","0.4310","38.8","13747","35706","29670","312","319","Uintah County, Utah","49","047"
"15077","8735","1939","3335","104551","22541","16573","16323","250","82010","71757","68339","3418","104551","83310","0.3806","37.3","108847","342098","307653","7951","4339","Davis County, Utah","49","011"
"313","223","0","15","3665","1206","753","748","5","2459","2058","1988","70","3665","55554","0.3689","37.8","4598","10056","9177","30","72","Emery County, Utah","49","015"
"177","117","17","0","1760","726","525","520","5","1034","841","767","74","1760","54565","0.4209","37.4","3913","4794","3973","21","43","Garfield County, Utah","49","017"
"1940","409","392","44","14587","4922","3050","2970","80","9665","7870","7319","551","14587","73991","0.4278","39.6","15678","36181","33147","481","240","Isle of Wight County, Virginia","51","093"
"298","93","0","17","3522","1262","635","607","28","2260","1619","1540","79","3522","40417","0.4326","38.8","3847","8033","7409","84","0","Franklin city, Virginia","51","620"
"568","532","73","0","2158","903","355","325","30","1255","738","544","194","2158","42632","0.4953","33.0","2447","7161","6494","162","157","Lexington city, Virginia","51","678"
"1592","458","77","95","21218","8449","5059","4865","194","12769","8935","8079","856","21218","37952","0.4514","39.0","26196","50684","44782","426","425","Henry County, Virginia","51","089"
"532","110","35","15","6078","1746","1244","1198","46","4332","3572","3516","56","6078","66987","0.3759","39.5","6983","16632","15591","219","96","King William County, Virginia","51","101"
"1765","386","43","43","13871","4934","3384","3153","231","8937","7200","6533","667","13871","60975","0.4702","40.0","17438","35946","31177","604","346","Louisa County, Virginia","51","109"
"1830","460","40","22","7185","2690","1541","1507","34","4495","3388","2850","538","7185","47202","0.4566","34.3","9435","21536","19686","204","119","Prince Edward County, Virginia","51","147"
"3998","965","273","86","30994","10697","7111","6806","305","20297","16505","15253","1252","30994","61864","0.4297","38.5","35504","79919","68520","1771","1366","Rockingham County, Virginia","51","165"
"1716","1695","358","31","14996","4399","2536","2451","85","10597","7577","6489","1088","14996","42273","0.4740","35.5","18820","38465","35215","499","656","Calloway County, Kentucky","21","035"
"627","335","28","18","6099","2168","1463","1353","110","3931","2769","2566","203","6099","34819","0.4503","39.0","7515","15511","13514","14","55","Casey County, Kentucky","21","045"
"1568","7678","1050","159","25721","6124","3572","3418","154","19597","15114","13945","1169","25721","43919","0.4601","44.4","29912","61799","55018","836","557","Christian County, Kentucky","21","047"
"2567","2243","444","223","40179","11786","6937","6563","374","28393","22019","20180","1839","40179","51673","0.4697","39.4","43122","98521","91508","913","1375","Daviess County, Kentucky","21","059"
"802","269","60","27","9758","3142","1884","1851","33","6616","5238","4950","288","9758","38612","0.4537","39.5","13667","25935","24370","126","131","Grayson County, Kentucky","21","085"
"1139","816","125","63","18643","5565","3259","3126","133","13078","9965","9166","799","18643","48926","0.4522","38.9","20560","44707","42114","317","167","Henderson County, Kentucky","21","101"
"1057","106","2","6","6044","1938","1315","1255","60","4106","3285","3004","281","6044","53926","0.4249","39.1","6769","15830","14323","140","5","Henry County, Kentucky","21","103"
"1513","268","37","58","18588","5580","3435","3302","133","13008","9830","9096","734","18588","47170","0.4489","39.9","21405","44314","40931","253","168","Hopkins County, Kentucky","21","107"
"316","160","0","51","5484","1718","910","867","43","3766","3122","2992","130","5484","32138","0.4647","39.5","6613","13263","12651","0","0","Jackson County, Kentucky","21","109"
"1954","704","87","14","22573","6848","4167","4054","113","15725","12352","11696","656","22573","41526","0.4832","40.0","25867","59570","55313","324","78","Laurel County, Kentucky","21","125"
"948","593","14","30","13121","4637","3027","2933","94","8484","6388","6047","341","13121","55113","0.4443","39.4","16175","30603","29022","129","52","Marshall County, Kentucky","21","157"
"1312","1742","149","47","10685","2710","1769","1648","121","7975","6531","6026","505","10685","56603","0.4064","39.9","12442","27131","25600","203","142","Meade County, Kentucky","21","163"
"1728","441","0","0","10481","3010","1960","1825","135","7471","6172","5618","554","10481","45516","0.4132","39.6","12007","27526","25433","77","106","Montgomery County, Kentucky","21","173"
"287","169","6","14","2804","841","492","467","25","1963","1577","1472","105","2804","38149","0.4718","38.5","3293","7057","6393","30","0","Nicholas County, Kentucky","21","181"
"3816","1240","256","77","20911","5303","3848","3778","70","15608","13715","13417","298","20911","99128","0.4385","39.2","21973","62296","58368","1144","616","Oldham County, Kentucky","21","185"
"1614","447","58","89","16663","5683","3457","3328","129","10980","8350","7530","820","16663","63819","0.4460","39.4","21152","37080","35460","320","173","Douglas County, Minnesota","27","041"
"267","79","8","2","2612","917","570","553","17","1695","1263","1181","82","2612","55466","0.4572","40.1","3302","5894","5545","17","36","Grant County, Minnesota","27","051"
"126","103","13","11","1860","610","336","323","13","1250","925","850","75","1860","59643","0.3943","40.6","2610","4157","3820","47","27","Kittson County, Minnesota","27","069"
"1347","443","105","62","10939","3248","2125","2051","74","7691","6222","5693","529","10939","71080","0.3919","40.0","12722","28106","26121","214","196","Le Sueur County, Minnesota","27","079"
"1005","44","21","8","3995","1371","851","814","37","2624","2045","1892","153","3995","48801","0.4906","39.7","5726","10695","10025","1","4","Owen County, Kentucky","21","187"
"707","126","12","22","6544","1949","1202","1155","47","4595","3569","3459","110","6544","35720","0.4805","39.1","7861","16522","15749","8","3","Rockcastle County, Kentucky","21","203"
"2924","1112","116","96","20551","4781","3141","3034","107","15770","13210","12039","1171","20551","70817","0.4126","39.7","22007","54373","50054","528","566","Scott County, Kentucky","21","209"
"8532","4830","673","79","48224","11321","7218","6859","359","36903","27797","23738","4059","48224","52270","0.4824","37.6","52886","127343","110768","3775","5815","Warren County, Kentucky","21","227"
"713","364","46","48","7605","2370","1689","1596","93","5235","4074","3926","148","7605","44036","0.4468","39.2","9482","20732","19014","182","95","Allen County, Kentucky","21","003"
"1322","241","17","20","8106","2630","1795","1764","31","5476","4186","3681","505","8106","49637","0.4524","39.9","9064","19821","18211","209","248","Bourbon County, Kentucky","21","017"
"3472","558","105","39","29690","8392","5619","5409","210","21298","17361","16334","1027","29690","63348","0.3926","39.3","31463","79729","75522","706","490","Bullitt County, Kentucky","21","029"
"247","33","0","26","3567","1245","837","816","21","2322","1690","1578","112","3567","45244","0.4396","40.9","4575","8769","7909","57","10","Crittenden County, Kentucky","21","055"
"422","145","0","15","2441","874","448","441","7","1567","1057","984","73","2441","30114","0.4688","36.2","3338","5680","5355","3","19","Fulton County, Kentucky","21","075"
"660","311","17","32","6388","1980","1227","1180","47","4408","3374","3130","244","6388","31198","0.4690","38.2","7633","15123","14137","20","41","Knott County, Kentucky","21","119"
"288","14","9","0","2651","924","499","472","27","1727","1306","1237","69","2651","39325","0.4048","39.5","3943","6373","6133","18","0","Menifee County, Kentucky","21","165"
"856","183","10","12","11351","3814","2499","2435","64","7537","6006","5612","394","11351","43590","0.4383","38.7","13798","30296","28339","122","78","Muhlenberg County, Kentucky","21","177"
"626","591","165","12","11226","3392","2105","2038","67","7834","6090","5677","413","11226","33640","0.5209","39.7","13000","26025","24562","65","39","Perry County, Kentucky","21","193"
"454","171","0","0","2898","1029","639","582","57","1869","1272","1220","52","2898","24623","0.4680","36.1","3726","7045","6867","9","5","Wolfe County, Kentucky","21","237"
"536","264","25","8","7622","2357","1614","1582","32","5265","4066","3929","137","7622","26840","0.4814","39.0","9026","19033","17635","26","29","Clay County, Kentucky","21","051"
"1165","373","8","20","10624","3743","2247","2159","88","6881","5068","4800","268","10624","26272","0.4862","37.8","13235","26033","24584","51","19","Bell County, Kentucky","21","013"
"196","142","0","7","2616","968","561","532","29","1648","1179","1115","64","2616","35344","0.4616","37.2","3662","6613","5894","20","41","Cumberland County, Kentucky","21","057"
"936","366","171","46","14316","4744","2632","2523","109","9572","6937","6451","486","14316","44043","0.4863","37.3","16886","36863","34071","412","284","Graves County, Kentucky","21","083"
"461","38","0","0","2839","917","525","487","38","1922","1178","1082","96","2839","25275","0.5105","38.5","3477","6453","6220","0","56","Lee County, Kentucky","21","129"
"861","48","0","28","4958","1584","989","969","20","3374","2809","2662","147","4958","41763","0.4497","40.0","5954","12548","11553","33","16","Butler County, Kentucky","21","031"
"664","442","15","0","4885","1693","1113","1076","37","3192","2477","2301","176","4885","43401","0.4240","39.4","6570","12046","11270","10","10","Edmonson County, Kentucky","21","061"
"800","290","8","7","7283","2353","1446","1380","66","4930","3996","3778","218","7283","48438","0.4465","39.9","8302","18520","17246","46","70","Harrison County, Kentucky","21","097"
"226","77","9","5","3318","1043","573","551","22","2275","1767","1590","177","3318","49158","0.4398","38.7","3885","8274","7832","14","17","Bracken County, Kentucky","21","023"
"2130","175","26","0","17853","4955","3178","2892","286","12898","10222","9351","871","17853","60127","0.4693","40.3","19051","45283","42877","193","197","Nelson County, Kentucky","21","179"
"328","165","8","87","8231","3066","1586","1567","19","5165","3991","3711","280","8231","34914","0.5368","40.3","10958","20229","17819","99","233","Wayne County, Kentucky","21","231"
"1163","72","8","34","7405","2237","1248","1174","74","5168","3661","3268","393","7405","40107","0.4515","39.2","8308","18437","17335","85","159","Marion County, Kentucky","21","155"
"577","449","5","0","5892","2315","1458","1392","66","3577","2777","2533","244","5892","50536","0.4519","40.5","7945","14345","13006","119","67","Trigg County, Kentucky","21","221"
"6409","3774","710","483","46997","11738","8033","7784","249","35259","28962","26936","2026","46997","78327","0.4166","39.3","49443","129906","118666","2710","2911","Boone County, Kentucky","21","015"
"2564","1350","194","34","18821","5321","3657","3537","120","13500","11122","10189","933","18821","58245","0.4954","38.1","20447","52513","47567","1178","706","Jessamine County, Kentucky","21","113"
"846","352","4","0","11961","3825","2193","2106","87","8136","6121","5771","350","11961","30181","0.5238","39.0","14740","31003","29163","189","34","Knox County, Kentucky","21","121"
"245","69","56","63","9721","3216","1863","1776","87","6505","4980","4722","258","9721","29886","0.5207","38.1","11758","22101","20992","17","28","Letcher County, Kentucky","21","133"
"336","128","0","0","3857","1404","813","773","40","2453","1926","1738","188","3857","50839","0.4749","39.6","4872","9177","8781","32","0","Livingston County, Kentucky","21","139"
"1364","1415","128","101","25702","8010","4905","4770","135","17692","13609","12813","796","25702","34856","0.5090","39.8","30934","58767","54812","237","137","Pike County, Kentucky","21","195"
"2285","926","218","96","16624","5005","3193","3095","98","11619","9655","8934","721","16624","67056","0.4546","39.1","17823","46154","41076","634","888","Shelby County, Kentucky","21","211"
"1834","53","25","4","8694","2461","1409","1357","52","6233","5040","4577","463","8694","55334","0.4075","39.4","9410","22306","21310","66","159","Anderson County, Kentucky","21","005"
"754","334","30","80","7598","2636","1734","1596","138","4962","3923","3562","361","7598","47190","0.4372","39.9","10829","19912","18393","74","41","Breckinridge County, Kentucky","21","027"
"2685","1073","490","127","21076","6169","3632","3473","159","14907","10215","9175","1040","21076","56274","0.4104","38.5","23252","49703","44290","577","653","Franklin County, Kentucky","21","073"
"376","604","42","0","6052","1800","1197","1156","41","4252","3367","3131","236","6052","28105","0.4873","37.4","7523","16032","15271","23","6","McCreary County, Kentucky","21","147"
"6252","2281","254","75","33359","8548","5163","4993","170","24811","18741","16189","2552","33359","50060","0.4676","37.3","36707","89947","83417","933","1106","Madison County, Kentucky","21","151"
"284","191","15","0","4074","1342","792","745","47","2732","2281","2179","102","4074","37386","0.4406","39.8","4736","9945","9272","47","35","Metcalfe County, Kentucky","21","169"
"227","6","0","0","1704","556","360","354","6","1148","853","805","48","1704","30284","0.5092","38.2","2230","4359","4196","12","0","Owsley County, Kentucky","21","189"
"649","290","0","22","7028","2070","1480","1350","130","4958","3732","3619","113","7028","48623","0.4271","40.0","7797","17828","16672","100","92","Simpson County, Kentucky","21","213"
"1886","863","50","27","14509","4622","2829","2681","148","9887","8049","7262","787","14509","54953","0.4544","39.8","15900","35598","33686","207","146","Clark County, Kentucky","21","049"
"399","186","68","0","4644","1330","841","817","24","3314","2705","2531","174","4644","44005","0.4911","41.0","5341","12105","10093","63","104","Todd County, Kentucky","21","219"
"296","107","0","1","4101","1102","596","579","17","2999","2241","1995","246","4101","43524","0.4884","39.8","4715","10391","9378","35","16","Carroll County, Kentucky","21","041"
"162","172","0","1","3985","1373","697","688","9","2612","1888","1808","80","3985","32184","0.5177","37.6","5320","10037","9126","44","0","Clinton County, Kentucky","21","053"
"485","218","6","2","3105","897","563","545","18","2208","1662","1489","173","3105","52167","0.3889","38.8","3920","8636","7830","8","47","Gallatin County, Kentucky","21","077"
"626","268","0","34","7459","2460","1525","1464","61","4999","3690","3508","182","7459","34029","0.4903","39.9","8994","19500","16894","12","19","Richland Parish, Louisiana","22","083"
"203","80","7","22","1946","683","405","388","17","1263","950","875","75","1946","44688","0.4420","39.7","2788","5473","4672","30","5","Mahnomen County, Minnesota","27","087"
"3824","592","22","461","20242","5655","3689","3432","257","14587","12370","11446","924","20242","83464","0.3569","38.5","21948","53902","51017","560","384","Chisago County, Minnesota","27","025"
"460","113","15","50","6261","2090","1211","1185","26","4171","3121","2899","222","6261","55404","0.4099","39.6","7327","15008","13728","169","127","Redwood County, Minnesota","27","127"
"432","137","16","36","4087","1303","790","763","27","2784","2197","2025","172","4087","59210","0.4057","40.1","4767","9648","9049","107","86","Yellow Medicine County, Minnesota","27","173"
"1173","262","184","39","9819","3463","2223","2110","113","6356","4924","4576","348","9819","53585","0.4060","41.0","13238","24309","21556","200","407","Todd County, Minnesota","27","153"
"3107","865","73","412","17372","4780","2994","2801","193","12592","9236","8104","1132","17372","49160","0.4506","37.5","21595","45872","41234","376","248","Beltrami County, Minnesota","27","007"
"5342","1847","513","710","26091","5882","3573","3381","192","20209","15576","11643","3933","26091","57429","0.4349","36.0","28415","66088","60472","1060","2039","Blue Earth County, Minnesota","27","013"
"325","376","21","23","8253","2742","1698","1636","62","5511","4160","3767","393","8253","60382","0.3990","40.1","8764","18443","17506","65","37","Houston County, Minnesota","27","055"
"165","110","49","5","3090","1174","684","654","30","1916","1425","1287","138","3090","53071","0.4409","40.3","3672","6598","6293","74","69","Lac qui Parle County, Minnesota","27","073"
"61","91","0","5","1470","598","334","334","0","872","621","580","41","1470","49967","0.3858","38.3","3806","3724","3592","18","7","Lake of the Woods County, Minnesota","27","077"
"1640","1102","67","336","24687","9076","5505","5277","228","15611","12132","11159","973","24687","58682","0.4335","39.5","36193","57546","53512","724","565","Otter Tail County, Minnesota","27","111"
"1188","315","29","32","7425","2252","1284","1209","75","5173","3924","3696","228","7425","56762","0.4386","38.6","7961","17796","16757","320","145","Waseca County, Minnesota","27","161"
"7811","4259","371","2194","85807","26576","14472","13599","873","59231","42133","34919","7214","85807","55646","0.4454","36.5","104654","196528","184900","2721","1943","St. Louis County, Minnesota","27","137"
"18208","3621","797","5987","128198","32936","21392","20567","825","95262","77527","70635","6892","128198","82175","0.3908","38.1","132137","347788","306835","18250","9156","Anoka County, Minnesota","27","003"
"10707","2832","1164","1256","59479","15146","9552","9165","387","44333","33815","28998","4817","59479","62789","0.4312","37.8","64664","157308","141798","3802","5986","Stearns County, Minnesota","27","145"
"18550","6998","1985","7409","161488","40165","24031","23043","988","121323","97867","88788","9079","161488","86036","0.4122","38.4","166598","419507","369034","21688","14034","Dakota County, Minnesota","27","037"
"1091","662","181","51","10018","2646","1577","1542","35","7372","5623","5039","584","10018","57730","0.4417","39.1","11277","25465","22472","628","844","Lyon County, Minnesota","27","083"
"302","100","16","8","3971","1372","837","810","27","2599","1974","1852","122","3971","60118","0.3895","41.6","4826","9300","8803","70","45","Marshall County, Minnesota","27","089"
"459","95","22","34","6085","1965","1117","1097","20","4120","3111","2807","304","6085","59028","0.4259","40.6","7353","14349","13250","100","212","Renville County, Minnesota","27","129"
"12796","3909","918","2981","94431","25478","16149","15335","814","68953","56802","52674","4128","94431","96671","0.4198","38.0","98421","252944","228785","10809","5823","Washington County, Minnesota","27","163"
"147","115","31","19","2691","1031","693","668","25","1660","1224","1057","167","2691","57432","0.4027","38.6","6126","5338","4769","74","144","Cook County, Minnesota","27","031"
"98","33","6","0","1490","572","288","283","5","918","689","651","38","1490","40000","0.4846","39.7","2286","3888","3066","4","8","Knox County, Missouri","29","103"
"506","94","21","35","5014","1531","857","832","25","3483","2641","2372","269","5014","46757","0.4116","39.5","6240","11156","10058","24","45","Montgomery County, Missouri","29","139"
"975","443","20","0","11530","3872","2269","2195","74","7658","5859","5385","474","11530","41062","0.4369","39.6","13748","28946","25650","36","18","Stoddard County, Missouri","29","207"
"1805","432","94","0","9286","2964","1879","1846","33","6322","4805","4195","610","9286","44261","0.4513","39.7","10893","23845","21041","127","112","Audrain County, Missouri","29","007"
"14585","6315","1343","1422","125201","33469","18747","18075","672","91732","66222","54668","11554","125201","46086","0.4692","38.1","133459","285833","248548","3761","2851","Greene County, Missouri","29","077"
"558","239","3","2","4139","1775","1023","899","124","2364","1769","1643","126","4139","38870","0.4196","39.1","5656","9085","7855","84","23","St. Clair County, Missouri","29","185"
"124","141","0","4","1475","494","315","295","20","981","682","627","55","1475","42694","0.4412","38.0","2106","4513","3791","29","10","Schuyler County, Missouri","29","197"
"1884","1500","27","78","16031","7443","5320","5057","263","8588","6752","6217","535","16031","53478","0.4508","39.0","41830","44913","38367","350","312","Camden County, Missouri","29","029"
"9048","1837","279","222","84444","22677","15236","14549","687","61767","51017","47066","3951","84444","65454","0.3916","38.7","90974","222265","200923","2389","1054","Jefferson County, Missouri","29","099"
"707","141","20","42","7371","2341","1237","1203","34","5030","3933","3590","343","7371","38679","0.4366","39.9","8606","17226","14554","33","37","New Madrid County, Missouri","29","143"
"378","109","0","0","4036","1484","946","901","45","2552","2147","2045","102","4036","55377","0.4127","38.9","5198","10174","9271","50","9","Ralls County, Missouri","29","173"
"566","167","30","24","4903","1616","779","760","19","3287","2488","2239","249","4903","52965","0.4489","39.2","5700","11520","10735","101","12","Custer County, Montana","30","017"
"43","89","0","1","737","315","206","199","7","422","345","285","60","737","54427","0.4086","43.6","1003","1579","1454","0","17","Powder River County, Montana","30","075"
"252","260","15","66","3150","844","475","463","12","2306","1710","1518","192","3150","43194","0.4745","39.3","4134","10953","7781","56","84","Roosevelt County, Montana","30","085"
"47","15","0","0","895","375","227","214","13","520","381","342","39","895","44875","0.5778","40.8","1129","2330","2116","13","0","Liberty County, Montana","30","051"
"237","606","8","9","4535","1262","667","642","25","3273","2260","2082","178","4535","67205","0.4090","40.7","5248","11199","9972","82","47","Richland County, Montana","30","083"
"339","64","14","0","1867","579","365","321","44","1288","910","865","45","1867","50721","0.4724","40.0","2369","4224","3745","121","22","Toole County, Montana","30","101"
"27","32","0","0","857","334","150","136","14","523","385","367","18","857","57440","0.4373","45.5","1134","1706","1590","34","7","Daniels County, Montana","30","019"
"52","28","2","0","906","307","199","192","7","599","374","351","23","906","43661","0.4657","43.5","1349","1954","1791","2","2","Judith Basin County, Montana","30","045"
"611","387","0","6","3903","1429","716","708","8","2474","1575","1518","57","3903","41820","0.4451","37.8","5203","8538","7776","67","58","Deer Lodge County, Montana","30","023"
"0","25","0","0","723","275","177","172","5","448","328","312","16","723","49701","0.4408","43.9","1064","1770","1639","12","0","McCone County, Montana","30","055"
"179","208","0","14","3166","994","652","644","8","2172","1744","1536","208","3166","57992","0.4245","39.9","4159","9075","7257","47","64","Rosebud County, Montana","30","087"
"504","342","14","8","3930","1302","605","590","15","2628","1986","1749","237","3930","58596","0.4262","41.0","4449","8709","8246","73","33","Dawson County, Montana","30","021"
"466","236","14","0","2364","930","626","581","45","1434","975","912","63","2364","60594","0.4298","39.6","2736","5900","5415","20","39","Broadwater County, Montana","30","007"
"56","162","0","9","1710","639","364","347","17","1071","690","648","42","1710","46212","0.4364","41.6","2352","4036","3353","24","6","Phillips County, Montana","30","071"
"36","0","0","2","213","91","60","57","3","122","87","87","0","213","51094","0.3334","47.8","322","477","451","0","0","Blaine County, Nebraska","31","009"
"59","146","3","0","830","297","178","169","9","533","398","383","15","830","47287","0.3795","43.0","1066","1817","1518","8","17","Deuel County, Nebraska","31","049"
"34","37","2","3","347","123","74","73","1","224","185","161","24","347","52708","0.3620","42.0","438","927","803","13","32","Logan County, Nebraska","31","113"
"182","37","5","2","2244","828","462","454","8","1416","1048","970","78","2244","51821","0.4085","42.2","2753","4913","4637","17","16","Thayer County, Nebraska","31","169"
"1443","469","83","88","12712","3975","2135","2045","90","8737","6339","5747","592","12712","53023","0.4435","39.0","13906","31310","27697","642","638","Adams County, Nebraska","31","001"
"175","49","11","30","2311","804","445","432","13","1507","1181","1063","118","2311","54979","0.4372","41.6","2644","5180","4816","37","6","Boone County, Nebraska","31","011"
"1387","148","75","31","19749","5842","3857","3645","212","13907","10956","10315","641","19749","48656","0.4713","40.7","23384","53530","47123","309","151","St. Martin Parish, Louisiana","22","099"
"1268","4115","785","11","17696","4092","2513","2438","75","13604","10418","9937","481","17696","49141","0.4534","43.9","22202","44034","38512","1046","542","Vernon Parish, Louisiana","22","115"
"721","143","66","31","5483","1906","1117","1054","63","3577","2710","2607","103","5483","38353","0.4908","42.5","7317","12485","11082","57","0","Winn Parish, Louisiana","22","127"
"14209","8932","1637","2946","164346","43222","26196","25049","1147","121124","85042","72895","12147","164346","54948","0.5052","38.3","194236","440747","386099","8476","8793","East Baton Rouge Parish, Louisiana","22","033"
"481","188","44","16","9158","3302","2042","1953","89","5856","4355","4104","251","9158","40336","0.4771","40.9","15056","23626","20643","73","93","Sabine Parish, Louisiana","22","085"
"1189","540","41","9","7925","2558","1643","1607","36","5367","4096","3959","137","7925","46446","0.4525","42.2","9952","21284","19300","121","45","Allen Parish, Louisiana","22","003"
"712","128","12","6","3832","1142","656","629","27","2690","1921","1814","107","3832","30350","0.5173","39.9","5106","9443","8346","49","10","Madison Parish, Louisiana","22","065"
"1402","125","0","30","11726","3629","1990","1853","137","8097","6483","6296","187","11726","42105","0.4987","41.9","13919","30941","28182","161","80","Jefferson Davis Parish, Louisiana","22","053"
"356","272","21","126","7719","2518","1737","1730","7","5201","4217","4002","215","7719","51603","0.4592","40.1","8919","21097","19085","36","44","St. James Parish, Louisiana","22","093"
"772","673","95","14","6989","2176","1341","1317","24","4813","3467","3334","133","6989","42505","0.4394","40.0","9338","19197","17502","22","45","Grant Parish, Louisiana","22","043"
"801","143","0","12","3869","1283","703","692","11","2586","1904","1805","99","3869","59637","0.4549","39.1","5446","12095","11007","53","130","West Feliciana Parish, Louisiana","22","125"
"11364","7016","2178","2347","169452","51778","31530","30201","1329","117674","84967","76913","8054","169452","54032","0.4658","39.8","188511","431285","347730","19323","15102","Jefferson Parish, Louisiana","22","051"
"257","190","12","26","8166","2818","1647","1614","33","5348","3627","3510","117","8166","30441","0.5495","39.3","11415","21033","18520","70","40","Monroe County, Alabama","01","099"
"1042","312","54","23","12677","4191","2602","2582","20","8486","6687","6519","168","12677","44886","0.4409","39.3","15296","32793","29644","77","103","Lawrence County, Alabama","01","079"
"7349","8432","1200","534","60237","13234","8537","8222","315","47003","33782","28867","4915","60237","51463","0.5026","37.2","68972","159913","139578","2812","5096","Lee County, Alabama","01","081"
"590","268","85","5","11997","4289","2303","2232","71","7708","6024","5798","226","11997","35930","0.4587","39.5","14737","29400","26631","105","93","Marion County, Alabama","01","093"
"376","487","75","25","7637","2727","1514","1473","41","4910","3785","3601","184","7637","39848","0.4907","38.9","9588","18561","16831","20","13","Pickens County, Alabama","01","107"
"463","106","8","33","5202","1625","781","759","22","3577","2206","2005","201","5202","24320","0.5289","34.8","6872","12666","10950","13","115","Sumter County, Alabama","01","119"
"17031","13443","1830","2666","261231","73850","44216","42375","1841","187381","133217","121427","11790","261231","53901","0.5009","39.4","307874","652887","575407","8239","9042","Jefferson County, Alabama","01","073"
"245","375","55","0","5300","2058","1344","1261","83","3242","2229","2179","50","5300","35892","0.4690","40.6","7359","12796","11391","46","36","Choctaw County, Alabama","01","023"
"668","267","106","11","11048","3627","2128","2083","45","7421","5893","5586","307","11048","43514","0.4276","39.1","14052","31264","26067","494","1047","Franklin County, Alabama","01","059"
"276","80","2","0","7361","2303","1167","1096","71","5058","2824","2737","87","7361","33241","0.5495","39.5","10348","19098","17368","12","31","Marengo County, Alabama","01","091"
"1578","4605","149","0","23262","5912","3472","3388","84","17350","12321","11560","761","23262","42443","0.4661","39.0","27680","56218","48491","734","546","Russell County, Alabama","01","113"
"804","424","11","21","10737","4045","2611","2521","90","6692","5074","4786","288","10737","41919","0.4515","39.9","16579","25636","23248","142","29","Cherokee County, Alabama","01","019"
"933","536","62","5","14852","5370","3205","3098","107","9482","7379","6826","553","14852","42189","0.4598","40.3","18976","36647","32270","161","149","Covington County, Alabama","01","039"
"210","44","0","44","4943","1720","997","982","15","3223","2540","2402","138","4943","43163","0.4921","39.3","6815","13611","12234","68","124","Crenshaw County, Alabama","01","041"
"775","330","60","0","15910","5196","2988","2869","119","10714","7811","7459","352","15910","33845","0.4691","40.3","20419","38879","34063","105","395","Dallas County, Alabama","01","047"
"4285","2629","393","0","38471","12843","7471","7177","294","25628","19771","17554","2217","38471","48094","0.4601","38.3","45001","91654","82220","490","687","Lauderdale County, Alabama","01","077"
"193","71","10","13","4251","1445","831","821","10","2806","2018","1920","98","4251","30036","0.5064","38.5","5224","9977","9093","10","0","Lowndes County, Alabama","01","085"
"518","573","45","18","7474","2732","1622","1528","94","4742","3097","2751","346","7474","33370","0.5095","35.1","10296","18449","16978","50","36","Macon County, Alabama","01","087"
"5599","2012","136","86","32143","9529","5814","5664","150","22614","18010","17028","982","32143","59686","0.4454","38.9","36056","91733","80900","1305","710","Limestone County, Alabama","01","083"
"10218","4961","525","47","79630","21677","14107","13856","251","57953","45630","42810","2820","79630","77799","0.4392","39.6","86988","211801","190581","4255","3853","Shelby County, Alabama","01","117"
"789","196","36","27","9592","3445","2026","1976","50","6147","4617","4292","325","9592","35788","0.4752","38.8","13669","23451","20390","71","110","Winston County, Alabama","01","133"
"4947","6060","742","45","80930","28759","18501","17779","722","52171","38474","35688","2786","80930","58320","0.4587","39.4","114164","210305","186016","3204","2406","Baldwin County, Alabama","01","003"
"5715","1154","349","18","29708","8457","5695","5563","132","21251","16616","15967","649","29708","60891","0.4413","40.8","34165","76190","69487","640","408","Elmore County, Alabama","01","051"
"419","637","23","9","20695","6945","4346","4246","100","13750","10563","10210","353","20695","41769","0.4516","38.6","25041","51352","45992","330","147","Jackson County, Alabama","01","071"
"2783","1092","89","70","31395","10031","6102","5773","329","21364","16073","15095","978","31395","41325","0.4670","40.2","37861","77376","69436","315","397","Talladega County, Alabama","01","121"
"433","138","25","0","5990","2213","1484","1410","74","3777","2902","2798","104","5990","41370","0.4989","41.1","8554","16418","14480","390","7","Washington County, Alabama","01","129"
"137","86","19","0","5198","1773","1132","1132","0","3425","2720","2572","148","5198","40845","0.4615","37.8","6799","13091","11632","86","19","Clay County, Alabama","01","027"
"3646","1756","69","92","45918","14210","8430","8239","191","31708","24742","22943","1799","45918","52156","0.4526","38.8","52050","117389","103016","1351","1734","Morgan County, Alabama","01","103"
"1652","769","518","38","11601","3287","1950","1894","56","8314","5317","4528","789","11601","37446","0.5367","36.9","16123","33132","28870","236","796","Pike County, Alabama","01","109"
"1488","412","180","25","21880","7326","4569","4460","109","14554","11090","10337","753","21880","48065","0.4467","39.2","26588","54306","49567","379","444","Colbert County, Alabama","01","033"
"2082","3353","301","7","18806","5761","3527","3439","88","13045","9934","9076","858","18806","47214","0.4479","39.8","23103","46283","39791","579","543","Dale County, Alabama","01","045"
"444","108","9","9","5650","1979","1214","1194","20","3671","2567","2417","150","5650","34046","0.4994","38.6","7792","14582","13177","14","10","Hale County, Alabama","01","065"
"1971","1183","147","51","26040","7992","4879","4785","94","18048","14235","13564","671","26040","40440","0.4723","39.3","31309","70519","58705","578","1595","DeKalb County, Alabama","01","049"
"353","443","0","39","13089","4630","2628","2599","29","8459","5911","5420","491","13089","36275","0.4818","39.2","16586","34190","29172","134","24","Escambia County, Alabama","01","053"
"764","286","0","9","8702","3282","1997","1892","105","5420","3992","3828","164","8702","43395","0.4815","40.0","12097","22393","20119","171","70","Randolph County, Alabama","01","111"
"4260","7399","1047","767","156251","46615","29118","28168","950","109636","78236","72263","5973","156251","47583","0.4760","38.9","183671","408589","352990","6149","3513","Mobile County, Alabama","01","097"
"342","142","3","0","3070","1267","542","542","0","1803","958","934","24","3070","23447","0.4938","35.8","4736","9135","8111","156","22","Perry County, Alabama","01","105"
"554","670","27","2","5680","2045","1188","1129","59","3635","2832","2677","155","5680","44741","0.4570","40.0","6844","14736","12798","77","53","Cleburne County, Alabama","01","029"
"169","42","7","9","4553","1814","1161","1132","29","2739","1888","1865","23","4553","37837","0.4296","39.6","7182","12349","10667","93","23","Conecuh County, Alabama","01","035"
"765","483","71","27","9345","3356","2055","2050","5","5989","4307","4137","170","9345","32525","0.4883","38.8","12013","22475","19591","136","204","Barbour County, Alabama","01","005"
"1239","233","25","0","6891","2284","1482","1471","11","4607","3446","3318","128","6891","47542","0.4487","40.0","9185","20632","18343","87","1","Bibb County, Alabama","01","007"
"3992","2517","130","185","44605","13980","8900","8534","366","30625","23183","21426","1757","44605","47255","0.4633","39.7","53631","112854","99915","1262","940","Calhoun County, Alabama","01","015"
"215","282","31","0","9090","3150","1976","1966","10","5940","3831","3696","135","9090","37404","0.5158","41.4","12784","23826","21465","43","13","Clarke County, Alabama","01","025"
"829","146","33","0","6802","2449","1631","1594","37","4353","3360","3180","180","6802","39856","0.4610","39.1","8505","16299","14922","120","21","Fayette County, Alabama","01","057"
"75","19","0","0","623","235","142","139","3","388","303","278","25","623","56250","0.4407","43.0","903","1374","1243","7","0","Rock County, Nebraska","31","149"
"56","30","26","1","1368","536","291","275","16","832","655","587","68","1368","50781","0.4203","42.7","1952","2977","2691","10","4","Sherman County, Nebraska","31","163"
"1847","856","243","15","13520","4007","2480","2369","111","9513","7343","6850","493","13520","53209","0.4441","42.2","15813","36328","32072","315","236","Beauregard Parish, Louisiana","22","011"
"330","96","39","6","5812","2047","1080","1044","36","3765","2698","2542","156","5812","30272","0.5069","39.9","7894","13224","11859","27","23","Bienville Parish, Louisiana","22","013"
"3822","3669","774","244","49377","11833","7633","7418","215","37544","28831","25921","2910","49377","54268","0.4529","40.8","56946","120404","106541","2280","1322","Bossier Parish, Louisiana","22","015"
"64","35","26","14","2734","812","572","563","9","1922","1666","1547","119","2734","53423","0.4348","41.5","4125","6900","6186","47","0","Cameron Parish, Louisiana","22","023"
"1451","165","11","10","6959","2516","1633","1630","3","4443","3414","3147","267","6959","51803","0.4662","39.0","8487","15929","14508","48","47","East Feliciana Parish, Louisiana","22","037"
"1536","842","79","38","15270","4276","2861","2690","171","10994","8910","8414","496","15270","57429","0.4469","40.7","17778","42582","37037","543","546","St. John the Baptist Parish, Louisiana","22","095"
"603","1101","71","19","8919","2276","1426","1382","44","6643","5572","5337","235","8919","57204","0.4797","42.5","10174","22161","20003","626","114","Plaquemines Parish, Louisiana","22","075"
"3817","1789","401","708","56556","15791","9221","8937","284","40765","29196","26651","2545","56556","41121","0.5229","38.9","68357","150889","134271","1235","839","Ouachita Parish, Louisiana","22","073"
"1369","906","42","36","17613","6109","3842","3684","158","11504","8781","8240","541","17613","37570","0.4585","40.2","21777","44573","39074","188","54","Washington Parish, Louisiana","22","117"
"2101","314","109","61","30485","9127","5239","5076","163","21358","16189","15243","946","30485","36403","0.5099","40.2","36925","82029","73458","209","173","St. Landry Parish, Louisiana","22","097"
"2031","301","108","32","22236","6391","3796","3518","278","15845","12804","12001","803","22236","43396","0.4791","40.6","26435","61533","54733","193","63","Acadia Parish, Louisiana","22","001"
"2152","247","238","16","19856","6086","3256","3145","111","13770","8887","8209","678","19856","40485","0.4689","40.5","23504","50188","44687","623","880","St. Mary Parish, Louisiana","22","101"
"7652","4699","325","183","92962","29221","19142","18188","954","63741","50861","47190","3671","92962","68905","0.4638","39.2","102909","252612","225573","4459","2608","St. Tammany Parish, Louisiana","22","103"
"608","197","13","42","7582","3025","1755","1726","29","4557","3333","3173","160","7582","44100","0.4869","39.5","11837","21811","19434","73","183","Union Parish, Louisiana","22","111"
"4434","3247","738","1591","95864","29018","16954","16174","780","66846","46780","42760","4020","95864","41797","0.5188","38.9","113247","241306","214771","2216","1920","Caddo Parish, Louisiana","22","017"
"3164","2005","275","48","43032","9788","6418","6128","290","33244","27195","25621","1574","43032","80527","0.4231","40.5","47391","122284","111957","1054","1108","Ascension Parish, Louisiana","22","005"
"10148","3995","726","967","91543","20866","12522","11942","580","70677","52521","45710","6811","91543","56999","0.4926","38.8","102491","239785","211619","2922","3183","Lafayette Parish, Louisiana","22","055"
"2276","458","189","36","26184","7275","4681","4569","112","18909","15030","13898","1132","26184","46861","0.4509","40.6","30595","71122","61824","787","601","Iberia Parish, Louisiana","22","045"
"2457","1074","218","0","17712","4624","2571","2498","73","13088","10026","7909","2117","17712","35467","0.5381","36.5","20251","46493","41115","551","830","Lincoln Parish, Louisiana","22","061"
"612","136","0","0","3857","1374","788","769","19","2483","2038","1998","40","3857","43886","0.4986","41.0","5330","10133","8828","20","0","St. Helena Parish, Louisiana","22","091"
"1059","368","42","54","16551","5490","3180","3020","160","11061","7950","7275","675","16551","28951","0.4850","39.7","19681","38304","34433","234","52","Webster Parish, Louisiana","22","119"
"1178","153","60","119","10821","3506","2235","2123","112","7315","5421","5131","290","10821","46006","0.5028","40.1","13055","27072","24343","128","38","De Soto Parish, Louisiana","22","031"
"2412","535","4","71","10903","3357","2191","2111","80","7546","5607","5261","346","10903","50161","0.4652","40.0","13396","29585","26502","120","46","Iberville Parish, Louisiana","22","047"
"4268","872","283","79","48410","12880","8483","8051","432","35530","29016","26992","2024","48410","63389","0.4271","39.9","56745","137892","124481","1144","438","Livingston Parish, Louisiana","22","063"
"413","129","1","10","9732","3210","1874","1834","40","6522","4743","4360","383","9732","32929","0.4848","38.1","12678","24843","22424","117","20","Morehouse Parish, Louisiana","22","067"
"10050","11571","2453","12119","153819","39170","20491","19022","1469","114649","62710","53225","9485","153819","41604","0.5696","38.6","191808","384363","332025","9121","7710","Orleans Parish, Louisiana","22","071"
"3630","1311","412","102","39972","10952","6597","6334","263","29020","23261","20792","2469","39972","48747","0.4879","41.6","45424","110681","96427","1123","885","Terrebonne Parish, Louisiana","22","109"
"4352","3903","371","374","77780","21393","13138","12482","656","56387","42204","38148","4056","77780","51148","0.4757","39.5","90168","199425","177407","2000","1754","Calcasieu Parish, Louisiana","22","019"
"560","225","28","0","5917","2104","1254","1239","15","3813","2644","2479","165","5917","26776","0.5331","39.2","7877","13848","12263","20","72","Claiborne Parish, Louisiana","22","027"
"1539","146","184","22","15163","4556","2723","2611","112","10607","7856","7229","627","15163","38565","0.5082","41.5","18534","36999","33654","133","128","Avoyelles Parish, Louisiana","22","009"
"1073","81","25","1","5971","2261","1289","1266","23","3710","2890","2749","141","5971","39139","0.4754","40.8","7878","14616","13133","81","79","Jackson Parish, Louisiana","22","049"
"1017","29","103","61","8960","3232","1793","1772","21","5728","4248","3853","395","8960","41480","0.5435","41.4","11589","21889","19659","141","26","Pointe Coupee Parish, Louisiana","22","077"
"1673","980","105","49","19212","4708","3372","3231","141","14504","11959","11232","727","19212","69019","0.4358","40.4","20710","52080","47096","872","388","St. Charles Parish, Louisiana","22","089"
"2854","766","278","290","36895","10258","6502","6119","383","26637","21178","19293","1885","36895","55506","0.4664","41.7","41117","97232","86711","777","981","Lafourche Parish, Louisiana","22","057"
"61","75","0","5","1792","793","450","427","23","999","722","675","47","1792","27500","0.4801","40.7","3432","4542","3684","28","12","Tensas Parish, Louisiana","22","107"
"483","119","11","7","4814","1645","993","981","12","3169","2700","2662","38","4814","42104","0.4607","45.2","6711","13560","12160","24","9","LaSalle Parish, Louisiana","22","059"
"1072","761","132","30","15336","6584","4012","3820","192","8752","6834","5973","861","15336","57720","0.4404","38.5","23978","33756","29537","587","257","Lincoln County, Maine","23","015"
"1499","1282","173","66","17236","6257","4261","3939","322","10979","8312","7160","1152","17236","51931","0.4422","37.6","22455","39375","34277","418","296","Waldo County, Maine","23","027"
"707","263","18","2","7025","2997","1836","1700","136","4028","3042","2704","338","7025","40890","0.4521","38.4","15463","16678","14678","108","189","Piscataquis County, Maine","23","021"
"769","1293","64","30","29516","11001","6192","5848","344","18515","13575","12439","1136","29516","41123","0.4627","38.6","39916","66515","58132","1927","837","Aroostook County, Maine","23","003"
"657","836","76","34","13791","5293","3109","2887","222","8498","6268","5641","627","13791","41347","0.4670","37.8","23364","30890","26084","579","488","Washington County, Maine","23","029"
"1033","886","34","61","17020","6858","3975","3813","162","10162","7617","6780","837","17020","57751","0.4364","37.5","24400","38387","33966","403","407","Knox County, Maine","23","013"
"1770","521","63","25","15980","5470","3281","3140","141","10510","7763","6988","775","15980","63694","0.4125","38.8","18830","35356","31735","722","612","Sagadahoc County, Maine","23","023"
"4233","2229","278","72","52105","16824","9740","8950","790","35281","26567","22918","3649","52105","55365","0.4396","38.5","62754","120100","108544","1428","1186","Kennebec County, Maine","23","011"
"1500","787","60","5","11848","4251","2551","2342","209","7597","5555","4904","651","11848","51422","0.4339","37.9","22181","29835","26450","229","171","Franklin County, Maine","23","007"
"1583","1064","168","184","23661","9106","5623","5051","572","14555","10992","9854","1138","23661","57178","0.4582","38.8","41260","54099","47021","754","796","Hancock County, Maine","23","009"
"20986","14838","3797","48244","239116","63242","32249","29466","2783","175874","111595","90809","20786","239116","50379","0.5145","38.9","294296","600459","522155","18562","20206","Baltimore city, Maryland","24","510"
"2578","353","36","66","8574","2883","1753","1645","108","5691","4135","3843","292","8574","37803","0.4665","35.9","11437","21611","19487","563","300","Somerset County, Maryland","24","039"
"6515","5184","953","1716","93955","27784","18160","17565","595","66171","54116","50079","4037","93955","89147","0.4128","38.8","100210","249491","229424","8825","2752","Harford County, Maryland","24","025"
"2690","1837","128","174","27399","9608","5287","4973","314","17791","13366","11611","1755","27399","45893","0.4390","37.3","32900","65844","61689","535","473","Allegany County, Maryland","24","001"
"185","86","4","12","2720","963","543","519","24","1757","1427","1310","117","2720","59348","0.3701","43.0","3101","6417","5936","65","34","Howard County, Nebraska","31","093"
"94","19","10","14","942","327","234","231","3","615","425","375","50","942","64053","0.4242","41.7","1348","1977","1815","36","26","Gosper County, Nebraska","31","073"
"7829","6901","1113","171","66260","14315","9257","8902","355","51945","42549","39110","3439","66260","82032","0.3868","39.5","69059","176609","159897","4044","3078","Sarpy County, Nebraska","31","153"
"23","26","2","1","904","404","232","232","0","500","371","347","24","904","47778","0.4572","41.8","1395","1909","1640","6","7","Boyd County, Nebraska","31","015"
"292","31","0","2","2510","823","449","427","22","1687","1186","1092","94","2510","60313","0.4542","42.4","2928","5318","4931","66","10","Fillmore County, Nebraska","31","059"
"16","48","0","0","318","143","100","94","6","175","92","88","4","318","41125","0.4108","45.8","455","667","608","2","0","Hooker County, Nebraska","31","091"
"1132","429","13","0","6600","1992","1181","1147","34","4608","3646","3311","335","6600","70389","0.3952","38.4","7159","16890","15796","111","123","Seward County, Nebraska","31","159"
"224","106","0","1","1507","502","274","266","8","1005","726","695","31","1507","46188","0.4840","42.5","1905","3459","3207","28","2","Webster County, Nebraska","31","181"
"316","43","23","7","3363","1088","604","585","19","2275","1696","1586","110","3363","58979","0.3958","40.6","4075","7861","7317","89","39","Butler County, Nebraska","31","023"
"23","0","1","0","197","93","39","39","0","104","74","66","8","197","42813","0.4787","49.4","279","427","376","0","2","Arthur County, Nebraska","31","005"
"836","234","41","11","8979","2982","1604","1555","49","5997","4293","3912","381","8979","53110","0.4212","40.2","10449","21284","19833","162","166","Gage County, Nebraska","31","067"
"219","46","1","0","2666","856","508","497","11","1810","1293","1204","89","2666","60266","0.4083","40.2","2967","6465","5822","40","206","Kearney County, Nebraska","31","099"
"1825","741","55","135","14205","3567","2037","1964","73","10638","7882","6975","907","14205","53188","0.4422","39.1","15306","34465","29571","645","1204","Madison County, Nebraska","31","119"
"356","147","16","0","3905","1172","666","660","6","2733","2045","1790","255","3905","59040","0.4328","42.1","4262","8860","8443","19","55","Phelps County, Nebraska","31","137"
"887","299","10","0","3708","987","552","528","24","2721","2133","1726","407","3708","56456","0.4430","35.8","3940","9301","8652","119","193","Wayne County, Nebraska","31","179"
"273","164","125","5","3586","1338","762","736","26","2248","1721","1611","110","3586","52332","0.4166","43.0","4946","8232","7516","49","23","Knox County, Nebraska","31","107"
"461","47","6","13","3373","1059","622","589","33","2314","1794","1658","136","3373","55649","0.4135","40.9","3821","7689","6849","43","95","Merrick County, Nebraska","31","121"
"49","45","6","0","1222","516","301","287","14","706","533","483","50","1222","46452","0.4490","41.7","1627","2610","2228","16","21","Pawnee County, Nebraska","31","133"
"65","4","0","0","346","126","84","83","1","220","145","138","7","346","51591","0.3746","45.2","561","783","690","0","4","Wheeler County, Nebraska","31","183"
"164","56","43","318","2198","541","352","309","43","1657","1285","1259","26","2198","88030","0.3986","42.9","2657","5597","4717","248","259","Lander County, Nevada","32","015"
"57","22","0","0","491","205","108","93","15","286","130","109","21","491","37375","0.3744","40.1","950","963","825","12","11","Esmeralda County, Nevada","32","009"
"90","118","1","0","2048","1001","452","427","25","1047","631","586","45","2048","35806","0.4515","39.3","2916","4388","3853","74","29","Mineral County, Nevada","32","021"
"485","146","31","0","2018","928","445","423","22","1090","860","804","56","2018","58462","0.3751","39.3","2637","4605","4103","57","10","Lincoln County, Nevada","32","017"
"7295","17839","2477","4175","182180","53011","33063","30298","2765","129169","97608","83193","14415","182180","64791","0.4605","38.7","197371","454261","361311","28427","21940","Washoe County, Nevada","32","031"
"3227","1864","168","200","22755","7957","4505","4319","186","14798","10891","9824","1067","22755","55718","0.4539","38.5","23974","52717","42077","2791","2265","Carson City, Nevada","32","510"
"6172","3304","623","259","58452","18266","11532","10680","852","40186","31801","28098","3703","58452","75737","0.4267","38.3","64960","146402","131040","4118","2930","Merrimack County, New Hampshire","33","013"
"1980","1231","43","49","25052","8722","5646","5262","384","16330","12695","11324","1371","25052","69447","0.4395","38.3","38607","60163","54476","973","714","Belknap County, New Hampshire","33","001"
"5233","6164","780","1200","48982","13063","8390","8032","358","35919","27788","23178","4610","48982","72960","0.4291","37.0","53883","127806","114363","2642","3166","Strafford County, New Hampshire","33","017"
"14239","8893","2660","26450","235362","76248","47213","44956","2257","159114","126324","117058","9266","235362","99733","0.4764","38.6","261579","617769","515895","49935","16889","Monmouth County, New Jersey","34","025"
"4193","1280","245","1229","53322","16274","10994","10536","458","37048","30097","27756","2341","53322","94520","0.4098","38.5","62418","140417","125129","7479","2288","Sussex County, New Jersey","34","037"
"14838","13568","6417","80228","285908","76579","45410","43315","2095","209329","152253","140946","11307","285908","61510","0.5551","38.1","317314","783478","534116","105194","54731","Essex County, New Jersey","34","013"
"10145","3469","630","3444","104908","31626","20207","19435","772","73282","59256","54301","4955","104908","87283","0.4174","38.4","113485","290013","263581","10392","3446","Gloucester County, New Jersey","34","015"
"10609","4233","3588","20402","165429","50854","33703","32260","1443","114575","93081","87589","5492","165429","69688","0.4701","37.8","177090","500290","324542","76045","37189","Passaic County, New Jersey","34","031"
"14212","16028","7275","73916","339856","109765","72112","69335","2777","230091","186314","174984","11330","339856","101144","0.4759","39.0","357828","924277","612771","169107","72894","Bergen County, New Jersey","34","003"
"3554","1724","332","820","41587","13447","7903","7559","344","28140","22037","20169","1868","41587","81307","0.4185","38.6","45473","105047","90940","6029","2115","Warren County, New Jersey","34","041"
"12969","9323","2306","7684","166391","52643","33914","32539","1375","113748","90450","83563","6887","166391","87416","0.4336","38.8","179414","430869","375337","25951","10975","Burlington County, New Jersey","34","005"
"672","475","246","63","8904","3509","1776","1618","158","5395","3934","3730","204","8904","29360","0.4726","39.9","11287","23663","18110","1353","2156","Luna County, New Mexico","35","029"
"846","742","101","262","12103","5474","3050","2837","213","6629","4269","3934","335","12103","38329","0.4874","35.7","20916","32601","28196","759","469","Taos County, New Mexico","35","055"
"530","620","8","5","5853","2420","1368","1276","92","3433","2280","2001","279","5853","36302","0.4291","39.4","10284","11611","10649","193","77","Colfax County, New Mexico","35","007"
"12","12","3","0","211","138","63","61","2","73","45","44","1","211","29375","0.6097","40.0","567","438","395","9","0","Harding County, New Mexico","35","021"
"121","179","0","7","3040","1401","615","597","18","1639","1056","983","73","3040","29035","0.4462","36.2","5690","8263","7505","80","179","Quay County, New Mexico","35","037"
"88","184","50","0","3986","1248","693","672","21","2738","1940","1920","20","3986","33784","0.5001","38.3","5276","10494","8895","5","25","Noxubee County, Mississippi","28","103"
"2046","485","56","39","10324","3405","2302","2116","186","6919","5822","5464","358","10324","51030","0.4222","39.4","11514","27941","24329","114","87","Tate County, Mississippi","28","137"
"1318","126","26","10","12488","3881","2520","2474","46","8607","6359","6038","321","12488","38304","0.4624","40.1","15057","33960","29417","72","73","Panola County, Mississippi","28","107"
"424","229","0","11","5181","1987","1214","1191","23","3194","2314","2159","155","5181","41464","0.4020","39.9","6519","12137","10565","47","10","Yalobusha County, Mississippi","28","161"
"439","233","82","32","4577","1558","838","793","45","3019","2137","1928","209","4577","49870","0.4035","38.9","5200","10318","9875","111","96","Winnebago County, Iowa","19","189"
"270","335","82","10","5030","1692","972","941","31","3338","2492","2235","257","5030","58000","0.4265","40.2","5580","11398","10685","95","45","Shelby County, Iowa","19","165"
"399","176","2","33","5353","2135","1101","1066","35","3218","2264","2122","142","5353","40167","0.4919","38.8","6625","12348","11317","47","15","Appanoose County, Iowa","19","007"
"568","312","11","5","6780","2087","1267","1239","28","4693","3743","3395","348","6780","61443","0.4429","39.4","7349","15914","15204","92","34","Iowa County, Iowa","19","095"
"696","540","7","2","6280","2242","1260","1192","68","4038","2798","2638","160","6280","51867","0.4179","39.5","7190","14172","13251","153","144","Page County, Iowa","19","145"
"650","754","87","1","8257","2818","1539","1482","57","5439","4287","3867","420","8257","65263","0.4045","38.0","8976","20008","19325","123","173","Winneshiek County, Iowa","19","191"
"1848","3175","326","311","36799","11047","6663","6380","283","25752","19698","17737","1961","36799","60065","0.4241","39.5","39936","92409","84127","1536","1380","Pottawattamie County, Iowa","19","155"
"1109","470","229","21","15419","4390","2545","2409","136","11029","8539","7536","1003","15419","56437","0.4045","39.2","16793","38887","32219","1502","2866","Marshall County, Iowa","19","127"
"1089","712","20","33","10954","3246","1976","1843","133","7708","5855","5475","380","10954","64000","0.4056","39.5","11963","25891","24842","200","117","Boone County, Iowa","19","015"
"563","557","27","32","7524","2093","1187","1169","18","5431","4177","3845","332","7524","57125","0.4092","38.9","8285","19785","15133","1150","1733","Buena Vista County, Iowa","19","021"
"262","148","13","45","3810","1275","645","630","15","2535","1917","1793","124","3810","55060","0.3970","40.3","4364","9041","8438","30","28","Howard County, Iowa","19","089"
"673","145","29","8","4452","1596","971","942","29","2856","2325","2148","177","4452","61161","0.4169","39.0","5804","10570","10035","17","137","Guthrie County, Iowa","19","077"
"419","76","7","4","4174","1368","777","758","19","2806","2055","1861","194","4174","54575","0.4256","40.7","4744","9447","8992","41","55","Humboldt County, Iowa","19","091"
"647","260","6","9","6462","1972","1079","1058","21","4490","3736","3641","95","6462","66316","0.4412","40.5","6980","15844","15220","67","30","Madison County, Iowa","19","121"
"","","","882","30758","12846","8061","7643","418","17912","13475","12647","828","30758","35928","0.5739","37.7","40073","86512","75751","3041","1689","Guaynabo Municipio, Puerto Rico","72","061"
"","","","98","12298","4843","3166","2915","251","7455","5567","5314","253","12298","19430","0.5450","34.3","18437","30976","27970","294","316","Fajardo Municipio, Puerto Rico","72","053"
"","","","128","8488","3308","2298","2256","42","5180","4131","3950","181","8488","19279","0.5183","35.4","10698","25638","23594","65","62","Aguas Buenas Municipio, Puerto Rico","72","007"
"","","","19","14160","5257","3762","3669","93","8903","6929","6746","183","14160","17715","0.5043","33.3","17113","39888","37125","138","22","Hatillo Municipio, Puerto Rico","72","065"
"","","","14","7367","2414","1443","1361","82","4953","3823","3596","227","7367","19827","0.4927","34.6","9194","21757","19844","10","0","Santa Isabel Municipio, Puerto Rico","72","133"
"","","","194","29682","12668","7553","7107","446","17014","12073","10730","1343","29682","14236","0.6147","33.4","40869","74713","69213","674","884","Mayagüez Municipio, Puerto Rico","72","097"
"","","","187","15635","6140","4283","4158","125","9495","7640","7093","547","15635","22669","0.4762","35.6","22868","49093","44895","291","240","Río Grande Municipio, Puerto Rico","72","119"
"","","","26","8848","3807","2595","2530","65","5041","3965","3779","186","8848","19919","0.4884","34.0","12530","26847","25594","80","5","Añasco Municipio, Puerto Rico","72","011"
"","","","401","8706","3462","2170","2079","91","5244","4121","3935","186","8706","17448","0.5637","35.8","10763","24217","21870","382","300","Cataño Municipio, Puerto Rico","72","033"
"","","","1","5515","2623","1630","1596","34","2892","2024","1829","195","5515","12995","0.5130","32.7","9358","16280","15540","21","12","Guánica Municipio, Puerto Rico","72","055"
"","","","280","8508","3192","2237","2097","140","5316","4277","3947","330","8508","17852","0.4922","34.8","11470","25746","23096","153","108","Loíza Municipio, Puerto Rico","72","087"
"","","","13","12376","4436","3156","2969","187","7940","6654","6197","457","12376","21667","0.5011","37.4","15327","37466","35032","44","167","Las Piedras Municipio, Puerto Rico","72","085"
"","","","100","18721","7481","4948","4618","330","11240","9056","8598","458","18721","19617","0.5012","35.9","24612","51992","46774","95","179","Vega Baja Municipio, Puerto Rico","72","145"
"349","58","0","8","2784","1108","685","672","13","1676","1197","1129","68","2784","32397","0.5807","40.5","4401","6668","6050","26","48","Lafayette County, Arkansas","05","073"
"466","142","0","0","7485","2568","1523","1466","57","4917","3543","3370","173","7485","29320","0.4944","40.2","10211","18450","16810","81","0","Phillips County, Arkansas","05","107"
"830","511","92","6","7503","2444","1625","1592","33","5059","4185","3950","235","7503","43923","0.4367","40.7","9840","21161","18045","446","1001","Yell County, Arkansas","05","149"
"178","59","28","0","4419","1347","844","782","62","3072","2208","2045","163","4419","43184","0.4510","40.4","5824","10780","9305","142","151","Bradley County, Arkansas","05","011"
"240","386","61","19","8243","3079","2076","2037","39","5164","3963","3635","328","8243","37974","0.4920","39.4","10135","19971","17429","167","283","Polk County, Arkansas","05","113"
"349","480","7","0","9658","3272","1973","1923","50","6386","4341","4086","255","9658","35425","0.4577","39.3","13095","23484","21663","64","94","Ouachita County, Arkansas","05","103"
"368","275","24","0","5363","1799","1092","1043","49","3564","2635","2480","155","5363","45113","0.4494","39.9","6512","12189","11405","28","0","Little River County, Arkansas","05","081"
"1102","2360","0","100","16426","4941","3053","2887","166","11485","8796","8221","575","16426","43371","0.4660","39.1","19568","42276","37748","172","370","Miller County, Arkansas","05","091"
"3231","2778","340","71","29055","8708","5430","5281","149","20347","15397","14506","891","29055","44029","0.4609","39.2","33779","78254","70423","513","792","White County, Arkansas","05","145"
"3801","1138","168","163","25660","10532","6000","5147","853","15128","11347","10056","1291","25660","47040","0.4817","37.0","34845","63494","54391","2393","2196","Lake County, California","06","033"
"4509","1954","462","288","26354","6897","4421","4057","364","19457","15909","14329","1580","26354","58054","0.4260","38.9","28586","74309","60741","4851","3335","Yuba County, California","06","115"
"5456","672","127","26","9280","3108","1915","1833","82","6172","4751","4335","416","9280","56352","0.4171","38.7","12783","21190","19612","372","274","Lassen County, California","06","035"
"16257","5608","2590","4526","189374","68097","41048","36712","4336","121277","96316","83729","12587","189374","81018","0.4536","37.1","207713","495516","397013","33802","34517","Sonoma County, California","06","097"
"4288","1123","1404","555","44829","14754","10608","10199","409","30075","24986","23948","1038","44829","47622","0.4704","37.6","57690","170981","109171","26517","21535","Imperial County, California","06","025"
"60993","22697","21789","123507","577177","156177","102837","96078","6759","421000","333263","288598","44665","577177","99406","0.4616","38.3","608096","1647749","1075694","282450","217529","Alameda County, California","06","001"
"4837","1539","634","1201","48705","17778","10930","10316","614","30927","25176","22797","2379","48705","88596","0.4712","37.5","55602","137806","103011","14097","12626","Napa County, California","06","055"
"111","19","0","4","1319","609","396","382","14","710","483","455","28","1319","52148","0.4594","36.8","2365","3013","2682","16","51","Sierra County, California","06","091"
"16597","2933","3858","4068","74296","18779","12157","11433","724","55517","45358","35684","9674","74296","70228","0.4928","35.9","77947","215938","160759","22208","22505","Yolo County, California","06","113"
"3873","897","451","151","40855","17611","11583","10515","1068","23244","17379","15633","1746","40855","66096","0.4697","36.5","53989","98232","87867","2519","1413","Nevada County, California","06","057"
"2519","1427","207","108","34408","13470","8000","6952","1048","20938","15773","13958","1815","34408","51416","0.4704","37.1","40960","86352","70954","3367","4618","Mendocino County, California","06","045"
"104983","100949","73219","279730","3316795","930438","637651","602273","35378","2386357","1827840","1608666","219174","3316795","68044","0.5002","38.0","3542800","10012895","6200215","1677498","1170001","Los Angeles County, California","06","037"
"46063","35223","34411","42965","640215","170907","122052","115371","6681","469308","388073","344367","43706","640215","124055","0.4664","38.7","672495","1917643","1130304","389420","315515","Santa Clara County, California","06","085"
"2083","726","57","38","19240","7913","4559","4137","422","11327","8247","7259","988","19240","45241","0.4772","37.6","24118","43356","38826","1265","699","Siskiyou County, California","06","093"
"2266","676","1","33","9945","3488","2221","1987","234","6457","4600","4148","452","9945","45283","0.4743","36.7","11379","24588","21368","900","713","Del Norte County, California","06","015"
"558","345","270","22","8231","3550","2313","2241","72","4681","3618","3118","500","8231","55771","0.4231","38.0","11064","18227","15904","389","118","Chaffee County, Colorado","08","015"
"2252","1786","310","1279","21498","5248","3644","3353","291","16250","13362","11887","1475","21498","75937","0.4031","39.2","24001","58401","44939","1860","2233","Garfield County, Colorado","08","045"
"30665","17977","2168","10567","232284","64454","40714","38493","2221","167830","128930","110925","18005","232284","82986","0.4329","38.8","240956","568063","506841","18580","11676","Jefferson County, Colorado","08","059"
"453","253","13","23","2301","668","319","313","6","1633","1255","1152","103","2301","54357","0.4096","38.8","3391","6252","5630","48","50","Rio Blanco County, Colorado","08","103"
"362","93","17","2","3183","1163","570","568","2","2020","1478","1413","65","3183","36084","0.4533","38.9","4433","8089","7125","64","52","Conejos County, Colorado","08","021"
"27806","11318","2676","9205","166450","35579","23638","22567","1071","130871","105735","94469","11266","166450","71202","0.4052","39.4","173200","500418","397550","25882","26367","Adams County, Colorado","08","001"
"2257","1650","322","1103","18171","4086","3008","2783","225","14085","11297","9239","2058","18171","84790","0.4694","39.8","32461","54502","41086","2368","3665","Eagle County, Colorado","08","037"
"615","498","145","61","5366","1275","687","671","16","4091","3162","2811","351","5366","57229","0.4418","38.5","6300","12968","10566","149","227","Moffat County, Colorado","08","081"
"84","56","33","0","774","249","112","112","0","525","376","373","3","774","53977","0.4367","45.8","989","1983","1673","53","25","Cheyenne County, Colorado","08","017"
"7525","7482","1634","469","89527","24326","14112","13538","574","65201","45439","41617","3822","89527","50124","0.4928","38.6","104697","221812","192222","3224","4107","Montgomery County, Alabama","01","101"
"3130","1609","229","169","34883","10930","6680","6498","182","23953","18860","17517","1343","34883","45983","0.4707","39.2","40597","94805","79595","1296","2254","Marshall County, Alabama","01","095"
"1164","484","95","28","20847","6769","4427","4227","200","14078","10957","10647","310","20847","49358","0.4570","41.0","24323","57217","49426","685","947","Blount County, Alabama","01","009"
"485","227","51","0","6630","2474","1509","1491","18","4156","3230","3014","216","6630","50017","0.4407","40.0","9155","16813","15047","89","23","Henry County, Alabama","01","067"
"9369","11407","1791","312","148189","38163","23826","23222","604","110026","79532","72325","7207","148189","65449","0.4620","38.6","161577","356952","312416","9241","5642","Madison County, Alabama","01","089"
"2015","1548","94","162","21397","6008","3789","3648","141","15389","12135","11428","707","21397","58731","0.4542","40.5","23493","54552","49544","720","432","Autauga County, Alabama","01","001"
"1362","695","23","15","16205","5892","3668","3535","133","10313","7983","7648","335","16205","45828","0.4689","40.5","22421","40016","36498","188","65","Tallapoosa County, Alabama","01","123"
"794","406","9","0","10383","3655","2331","2300","31","6728","5115","4602","513","10383","41732","0.4400","40.4","12869","26143","22610","162","67","Geneva County, Alabama","01","061"
"311","45","25","9","3854","1402","827","758","69","2452","1669","1526","143","3854","31014","0.4887","37.9","5777","10413","9278","1","0","Wilcox County, Alabama","01","131"
"162","373","180","31","1187","187","114","111","3","1000","730","621","109","1187","87466","0.3514","57.4","1983","5473","2528","831","1155","Aleutians West Census Area, Alaska","02","016"
"54","40","1","2","314","66","40","33","7","248","177","161","16","314","79808","0.3916","47.7","952","860","670","4","10","Bristol Bay Borough, Alaska","02","060"
"616","717","230","2","4261","838","624","543","81","3423","2639","2424","215","4261","85839","0.3720","42.8","5422","12812","8379","1111","1119","Kodiak Island Borough, Alaska","02","150"
"139","238","4","27","1795","410","329","324","5","1385","1107","994","113","1795","60906","0.4469","42.9","2745","7694","5647","50","19","Northwest Arctic Borough, Alaska","02","188"
"2657","1003","114","57","20804","7220","4266","4124","142","13584","10322","9561","761","20804","43285","0.4627","39.1","23418","52219","45805","469","430","McMinn County, Tennessee","47","107"
"1461","328","29","21","12324","3658","2277","2175","102","8666","6946","6449","497","12324","53197","0.4045","40.8","13669","32607","29640","85","428","Marshall County, Tennessee","47","117"
"1259","448","125","23","12177","4184","2648","2560","88","7993","6124","5675","449","12177","42206","0.4506","38.1","14673","32372","28877","104","290","Rhea County, Tennessee","47","143"
"206","226","53","10","8664","2629","1593","1488","105","6035","4995","4571","424","8664","38864","0.4584","39.8","10018","21638","19319","39","20","Scott County, Tennessee","47","151"
"3624","1866","251","91","30541","10656","6644","6337","307","19885","15361","14213","1148","30541","50392","0.4651","39.0","34971","75092","65961","1041","1060","Anderson County, Tennessee","47","001"
"805","370","7","29","7443","2688","1690","1646","44","4755","3542","3283","259","7443","36520","0.4208","38.6","9045","18034","16469","129","45","Fentress County, Tennessee","47","049"
"1730","504","83","8","19320","6192","3586","3442","144","13128","10043","9545","498","19320","43171","0.4505","39.3","22592","48099","43542","165","178","Gibson County, Tennessee","47","053"
"840","92","1","52","8891","3074","1974","1927","47","5817","4147","3889","258","8891","40304","0.4381","38.1","10997","21590","19257","106","64","Hardeman County, Tennessee","47","069"
"2010","1270","70","34","20669","9062","6072","5942","130","11607","9162","8673","489","20669","58065","0.4513","39.1","23083","51966","44063","1328","1224","Loudon County, Tennessee","47","105"
"15418","9633","974","561","111676","22930","15531","14845","686","88746","72401","63235","9166","111676","67429","0.4065","39.2","118691","313400","270836","8963","6796","Rutherford County, Tennessee","47","149"
"841","144","12","20","7603","2285","1478","1431","47","5318","4147","3978","169","7603","48068","0.5148","39.3","8794","19546","17792","111","165","Smith County, Tennessee","47","159"
"5555","3491","491","560","49664","14446","10152","9834","318","35218","29687","28016","1671","49664","75991","0.4095","40.0","53339","135542","122005","2882","2181","Wilson County, Tennessee","47","189"
"508","543","138","35","7658","2956","1680","1628","52","4702","3719","3325","394","7658","41890","0.4335","39.8","8903","17440","15428","106","145","Unicoi County, Tennessee","47","171"
"607","559","69","11","7566","3649","2452","2319","133","3917","2732","2531","201","7566","46216","0.4648","37.8","18156","19257","16179","614","448","Lincoln County, New Mexico","35","027"
"1552","1705","380","284","23284","7209","4250","4039","211","16075","12277","11692","585","23284","43359","0.4608","39.9","27279","64044","51344","3215","3055","Chaves County, New Mexico","35","005"
"1266","1902","106","36","22523","5574","3637","3491","146","16949","13709","13097","612","22523","60546","0.4423","43.1","26610","68221","51295","3007","5034","Lea County, New Mexico","35","025"
"3236","4165","460","727","61921","23853","14623","13326","1297","38068","26219","23452","2767","61921","61200","0.4882","37.2","72988","147742","121365","5381","4977","Santa Fe County, New Mexico","35","049"
"288","77","0","0","1395","593","240","220","20","802","570","523","47","1395","35884","0.4976","41.4","2347","3485","2891","67","43","Union County, New Mexico","35","059"
"418","95","32","15","5555","2874","1391","1284","107","2681","1600","1521","79","5555","29755","0.5346","36.9","8555","10772","9766","179","257","Sierra County, New Mexico","35","051"
"397","336","138","17","4520","1703","1004","910","94","2817","1694","1496","198","4520","42083","0.4472","35.9","8234","16748","14287","383","707","Socorro County, New Mexico","35","053"
"1303","717","384","30","6814","1828","1052","990","62","4986","3690","3132","558","6814","42702","0.4456","38.3","8518","18380","15258","409","702","Roosevelt County, New Mexico","35","041"
"5011","7481","1386","391","77842","23210","15557","14959","598","54632","42589","37895","4694","77842","40973","0.4918","37.3","87897","212563","162882","13495","14330","Doña Ana County, New Mexico","35","013"
"353","911","195","332","7931","2256","1287","1225","62","5675","4025","3732","293","7931","121324","0.3909","38.9","8384","18537","16234","1121","597","Los Alamos County, New Mexico","35","028"
"1257","507","22","121","12730","4591","2709","2443","266","8139","5517","5133","384","12730","39952","0.5084","39.4","20184","38976","34263","691","461","Rio Arriba County, New Mexico","35","039"
"918","440","88","91","11609","4217","1908","1772","136","7392","5030","4657","373","11609","30946","0.5040","36.1","15984","27140","24824","317","456","San Miguel County, New Mexico","35","047"
"2550","1365","238","289","27010","9292","6088","5749","339","17718","13777","12651","1126","27010","48945","0.4353","37.3","31208","74556","65320","1697","1445","Valencia County, New Mexico","35","061"
"627","642","32","2","5644","2180","1190","1140","50","3464","2636","2506","130","5644","36120","0.4594","38.5","8026","15216","13992","170","146","Torrance County, New Mexico","35","057"
"11058","17896","3419","5420","267699","76129","45166","42160","3006","191570","132869","116649","16220","267699","53329","0.4770","37.9","293787","670723","566802","26718","21879","Bernalillo County, New Mexico","35","001"
"1246","4726","2119","219","23634","7741","4646","4403","243","15893","11120","10165","955","23634","41988","0.4724","39.0","31745","60389","50919","2330","2016","Otero County, New Mexico","35","035"
"1344","562","33","22","8708","2951","1786","1611","175","5757","4639","4388","251","8708","39413","0.4545","38.3","11397","25525","22917","139","139","Cibola County, New Mexico","35","006"
"52","30","0","0","672","314","90","86","4","358","270","246","24","672","31625","0.4282","38.0","1092","2015","1914","17","2","De Baca County, New Mexico","35","011"
"295","15","5","0","1384","751","280","280","0","633","354","321","33","1384","24798","0.4691","35.2","2670","3650","3419","7","38","Guadalupe County, New Mexico","35","019"
"0","80","0","0","1325","906","566","473","93","419","322","318","4","1325","41910","0.3830","34.0","3756","3519","3094","38","12","Catron County, New Mexico","35","003"
"30367","10009","12949","348100","503829","137182","77773","73610","4163","366647","269314","251751","17563","503829","40088","0.5118","36.8","529796","1414023","866147","236741","190064","Bronx County, New York","36","005"
"10588","9134","4273","6338","185324","55320","31099","29179","1920","130004","96174","82920","13254","185324","61359","0.4654","37.7","208376","457795","406417","19245","15204","Onondaga County, New York","36","067"
"5055","1248","219","246","31301","9286","5501","5148","353","22015","16601","14057","2544","31301","56365","0.4278","36.9","36576","75998","70223","1634","1172","Clinton County, New York","36","019"
"2024","418","65","92","13564","4505","2676","2458","218","9059","6965","6079","886","13564","54545","0.4376","38.7","16361","31683","28434","424","209","Seneca County, New York","36","099"
"3244","571","267","3680","34854","11516","8000","7543","457","23338","19068","17940","1128","34854","104486","0.4229","38.4","38620","98320","83668","7531","3488","Putnam County, New York","36","079"
"1931","337","30","185","24524","8600","5019","4739","280","15924","12084","10878","1206","24524","54646","0.4152","37.4","33831","61428","56912","1011","449","Herkimer County, New York","36","043"
"4578","2214","462","360","44787","15100","8730","8044","686","29687","22680","20350","2330","44787","64944","0.4511","38.2","50857","108596","101338","2128","1572","Ontario County, New York","36","069"
"2200","1247","209","263","39861","12645","7624","7133","491","27216","20339","18423","1916","39861","53663","0.4533","38.4","49585","95301","87282","1221","1599","Steuben County, New York","36","101"
"127","29","10","7","1157","553","343","334","9","604","491","452","39","1157","58675","0.3979","36.0","8948","4493","4143","70","4","Hamilton County, New York","36","041"
"3501","2003","354","182","53075","17800","10136","9546","590","35275","25618","22803","2815","53075","46820","0.4519","37.8","67645","126145","116989","1351","1050","Chautauqua County, New York","36","013"
"46623","28598","22335","733657","958567","266233","166723","158773","7950","692334","512916","430233","82683","958567","60231","0.5264","38.7","1044493","2576511","1571448","538110","279114","Kings County, New York","36","047"
"1565","950","51","84","20030","6801","4251","4039","212","13229","10414","9606","808","20030","62999","0.4177","38.2","22527","48307","45409","529","358","Tioga County, New York","36","107"
"2165","204","133","118","16563","5275","3167","2985","182","11288","8838","7970","868","16563","52620","0.4208","38.9","18584","38200","35449","503","298","Orleans County, New York","36","073"
"8543","6482","976","877","94406","28166","17548","16726","822","66240","51616","45980","5636","94406","84291","0.4188","38.9","106029","225586","206718","6378","4981","Saratoga County, New York","36","091"
"1428","899","217","765","24966","9401","5756","5372","384","15565","11820","10356","1464","24966","66787","0.4663","38.4","33486","58739","52735","2054","1256","Columbia County, New York","36","021"
"629","267","42","45","10247","3168","2069","1949","120","7079","5616","5018","598","10247","54524","0.4002","39.8","15679","26263","24526","93","194","Lewis County, New York","36","049"
"26181","11148","7915","108564","349292","113607","69255","66107","3148","235685","185720","173701","12019","349292","96610","0.5405","39.0","374923","956650","690718","130195","79976","Westchester County, New York","36","119"
"1585","463","70","259","18968","7537","4366","4025","341","11431","8342","7364","978","18968","49544","0.4412","37.8","31609","44562","40522","1018","729","Delaware County, New York","36","025"
"1703","656","334","160","19660","6338","3589","3271","318","13322","10154","9132","1022","19660","49462","0.4472","37.9","23496","48528","43676","1090","684","Montgomery County, New York","36","057"
"8524","2248","1852","62647","166246","54563","36925","35611","1314","111683","91548","87264","4284","166246","82783","0.4551","37.8","180325","470833","352170","70674","27610","Richmond County, New York","36","085"
"4692","1367","348","152","41933","13010","7364","6842","522","28923","22256","19621","2635","41933","50940","0.4421","36.4","53194","105260","95481","1704","1799","St. Lawrence County, New York","36","089"
"5335","6761","2323","3286","39618","10049","6345","5701","644","29569","20542","14749","5793","39618","60240","0.4960","34.5","43471","101802","85654","5245","7421","Tompkins County, New York","36","109"
"2959","754","124","296","28015","9707","5770","5477","293","18308","13117","11350","1767","28015","61024","0.4358","38.0","39952","63639","59167","1272","735","Warren County, New York","36","113"
"1913","617","86","206","17745","5362","3445","3244","201","12383","9742","8150","1592","17745","56023","0.4434","36.9","20737","47408","45062","608","243","Cortland County, New York","36","023"
"11465","4983","1445","7839","108413","35056","22401","21081","1320","73357","56752","51620","5132","108413","81219","0.4497","37.8","120789","285513","243927","18437","9708","Dutchess County, New York","36","027"
"295","335","24","18","4030","1402","842","805","37","2628","1957","1830","127","4030","50903","0.4606","40.7","4844","8461","7259","119","130","Platte County, Wyoming","56","031"
"1037","809","37","10","13251","4374","2922","2569","353","8877","6305","5549","756","13251","60807","0.4313","39.6","14915","29711","26073","314","173","Sheridan County, Wyoming","56","033"
"329","728","13","27","4475","1686","1027","976","51","2789","2144","2030","114","4475","52804","0.4071","40.0","5474","11651","9675","77","79","Big Horn County, Wyoming","56","003"
"183","354","56","35","2919","942","595","537","58","1977","1521","1469","52","2919","65132","0.4008","42.3","3656","7397","6675","48","21","Crook County, Wyoming","56","011"
"552","1546","38","52","12160","4498","2986","2854","132","7662","5813","5312","501","12160","63582","0.4373","39.3","14452","28957","24979","388","272","Park County, Wyoming","56","029"
"2287","3017","448","284","15944","3188","1699","1605","94","12756","9198","5973","3225","15944","49322","0.4697","37.0","19266","38169","32703","821","1503","Albany County, Wyoming","56","001"
"609","558","60","10","6204","1855","1132","1072","60","4349","3253","2984","269","6204","60161","0.4115","41.8","8803","14458","12412","194","279","Carbon County, Wyoming","56","007"
"362","785","23","0","5207","1982","1146","1122","24","3225","2624","2450","174","5207","54289","0.4197","39.3","6031","12868","11304","28","79","Goshen County, Wyoming","56","015"
"327","601","5","302","7597","2014","1365","1350","15","5583","4313","3963","350","7597","63403","0.3861","40.1","9041","20281","17762","96","152","Uinta County, Wyoming","56","041"
"291","129","11","0","3365","1215","734","691","43","2150","1655","1500","155","3365","54158","0.3868","41.0","3860","7870","6643","44","1","Washakie County, Wyoming","56","043"
"224","96","17","9","2118","780","498","463","35","1338","943","901","42","2118","51413","0.4149","42.2","2611","4533","3888","3","6","Hot Springs County, Wyoming","56","017"
"820","1081","60","192","14907","4974","3145","2923","222","9933","7539","6735","804","14907","55896","0.4328","39.9","18010","39199","31473","391","145","Fremont County, Wyoming","56","013"
"403","398","46","10","3340","1088","804","791","13","2252","1600","1490","110","3340","77403","0.3964","39.0","6028","9861","8387","51","46","Sublette County, Wyoming","56","035"
"270","317","0","300","2891","969","583","583","0","1922","1527","1395","132","2891","57031","0.4119","39.7","3562","6709","5810","24","81","Weston County, Wyoming","56","045"
"","","","0","8592","3286","2207","2124","83","5306","4376","4057","319","8592","20521","0.4769","34.7","9913","22955","22024","52","85","Aibonito Municipio, Puerto Rico","72","009"
"","","","0","12558","4155","2863","2602","261","8403","6784","6278","506","12558","19605","0.5028","35.6","15608","38718","35192","19","84","Juncos Municipio, Puerto Rico","72","077"
"","","","0","7665","3725","2476","2386","90","3940","2950","2766","184","7665","13992","0.5283","34.0","12244","22789","21612","86","38","Lajas Municipio, Puerto Rico","72","079"
"","","","0","5771","2224","1576","1499","77","3547","2808","2672","136","5771","14012","0.5028","32.9","7586","17837","16584","7","11","Adjuntas Municipio, Puerto Rico","72","001"
"","","","17","11394","4202","2664","2626","38","7192","5709","5583","126","11394","17000","0.5307","33.2","14148","31453","29665","146","93","Camuy Municipio, Puerto Rico","72","027"
"","","","26","8058","2843","1844","1762","82","5215","4009","3646","363","8058","19432","0.4396","35.3","11418","26043","24230","50","34","Naguabo Municipio, Puerto Rico","72","103"
"","","","34","8424","3526","2161","2161","0","4898","4088","4000","88","8424","18883","0.4886","33.6","10361","28061","26521","24","1","Naranjito Municipio, Puerto Rico","72","105"
"","","","128","31910","12637","8071","7660","411","19273","14991","14328","663","31910","18647","0.5060","34.5","41312","84721","79307","304","236","Arecibo Municipio, Puerto Rico","72","013"
"","","","30","5908","2128","1325","1306","19","3780","2976","2869","107","5908","17570","0.4681","34.4","8364","17791","17188","5","8","Arroyo Municipio, Puerto Rico","72","015"
"","","","0","8083","3066","1952","1918","34","5017","3975","3733","242","8083","17473","0.5081","33.2","10392","23626","22371","174","57","Quebradillas Municipio, Puerto Rico","72","115"
"","","","66","14022","5183","3258","3145","113","8839","6327","5970","357","14022","17261","0.5098","34.6","18264","38730","36127","114","140","Guayama Municipio, Puerto Rico","72","057"
"","","","0","482","230","100","93","7","252","198","155","43","482","23333","0.4674","37.2","1528","1311","1115","5","29","Culebra Municipio, Puerto Rico","72","049"
"","","","78","14529","4679","3400","3321","79","9850","7792","7385","407","14529","35018","0.5402","37.1","17209","46721","42532","186","272","Gurabo Municipio, Puerto Rico","72","063"
"","","","11","7989","2890","2014","1890","124","5099","3904","3759","145","7989","17154","0.4960","35.7","10042","24069","22827","108","34","Barceloneta Municipio, Puerto Rico","72","017"
"","","","162","10990","5006","2940","2829","111","5984","4451","4056","395","10990","14743","0.5070","33.8","17521","35264","32975","106","26","Yauco Municipio, Puerto Rico","72","153"
"","","","32","21635","8259","5398","5097","301","13376","10191","9569","622","21635","16269","0.5604","35.6","27278","51556","48549","293","178","Aguadilla Municipio, Puerto Rico","72","005"
"","","","48","15473","6940","4522","4276","246","8533","6439","5966","473","15473","16708","0.5436","35.1","29578","48363","45582","188","177","Cabo Rojo Municipio, Puerto Rico","72","023"
"","","","15","6144","2430","1512","1398","114","3714","2786","2565","221","6144","16007","0.5077","36.3","8744","16913","15873","79","30","Patillas Municipio, Puerto Rico","72","109"
"","","","40","7908","2755","1897","1803","94","5153","4366","4070","296","7908","19877","0.5174","33.7","9270","22271","21392","0","43","Villalba Municipio, Puerto Rico","72","149"
"","","","1093","61909","24300","15610","15036","574","37609","27612","25399","2213","61909","29059","0.4901","36.7","77009","153138","132627","4579","3208","Carolina Municipio, Puerto Rico","72","031"
"","","","72","16213","6292","4200","4009","191","9921","7916","7428","488","16213","22518","0.5059","35.6","20010","43743","40294","115","166","Cayey Municipio, Puerto Rico","72","035"
"","","","0","17615","7066","4422","4263","159","10549","8070","7633","437","17615","20434","0.5459","35.2","26487","52157","49276","454","168","Humacao Municipio, Puerto Rico","72","069"
"","","","95","9645","3111","2232","2124","108","6534","5492","5327","165","9645","20941","0.4506","36.4","11673","30939","28954","206","11","Morovis Municipio, Puerto Rico","72","101"
"","","","240","23800","8708","6060","5847","213","15092","12031","11348","683","23800","32545","0.4824","37.4","29335","66041","59052","1034","696","Trujillo Alto Municipio, Puerto Rico","72","139"
"","","","31","14825","5846","4040","3796","244","8979","7081","6788","293","14825","18502","0.5234","35.6","18560","38680","35536","60","55","Manatí Municipio, Puerto Rico","72","091"
"","","","0","6863","2403","1662","1610","52","4460","3636","3557","79","6863","16718","0.5109","32.9","8705","20362","19698","47","1","Peñuelas Municipio, Puerto Rico","72","111"
"","","","15","5018","2265","1168","1070","98","2753","1951","1860","91","5018","19907","0.4948","33.5","9404","14022","13254","57","130","Rincón Municipio, Puerto Rico","72","117"
"","","","31","11722","5451","3149","3035","114","6271","4735","4414","321","11722","16486","0.5532","33.5","15696","31345","29812","145","34","San Germán Municipio, Puerto Rico","72","125"
"","","","50","13313","5839","3982","3822","160","7474","6049","5860","189","13313","15331","0.5475","34.9","18010","36991","34721","142","185","San Sebastián Municipio, Puerto Rico","72","131"
"18659","13404","5663","10106","301948","89039","50363","47491","2872","212909","155106","134684","20422","301948","60075","0.4639","37.4","327880","736134","651574","35945","24414","Monroe County, New York","36","055"
"6587","2514","1059","981","89729","29504","16982","16181","801","60225","44417","39908","4509","89729","56027","0.4537","37.7","105267","222440","197691","9450","6436","Oneida County, New York","36","065"
"6505","1812","536","2195","69320","24243","14634","13436","1198","45077","33366","29046","4320","69320","64304","0.4592","37.3","85139","174315","153349","7533","4013","Ulster County, New York","36","111"
"2084","892","159","804","33989","10996","6131","5846","285","22993","17293","15425","1868","33989","54940","0.4423","37.9","38870","81599","75746","1301","1069","Chemung County, New York","36","015"
"3732","522","151","189","24176","7824","4737","4390","347","16352","12684","11094","1590","24176","59510","0.4238","37.0","27506","61017","57181","872","1022","Livingston County, New York","36","051"
"3559","833","254","472","23409","8579","5322","4878","444","14830","11046","9616","1430","23409","54028","0.4465","36.6","31232","59306","54605","1146","697","Otsego County, New York","36","077"
"999","301","174","254","17100","6918","3628","3421","207","10182","7585","6783","802","17100","53601","0.4526","37.8","29678","44501","40105","2095","425","Greene County, New York","36","039"
"15204","4084","2250","9552","126540","35873","19951","18867","1084","90667","61436","50675","10761","126540","66252","0.4600","37.0","141553","303159","262078","18112","13481","Albany County, New York","36","001"
"2084","621","124","70","17948","6145","3658","3402","256","11803","8942","8077","865","17948","48412","0.4400","36.8","26373","46221","42093","465","594","Allegany County, New York","36","003"
"1737","868","189","128","31779","10263","6033","5668","365","21516","15776","14060","1716","31779","48703","0.4326","37.8","41596","76342","69703","854","509","Cattaraugus County, New York","36","009"
"2851","1143","419","120","25877","8593","5152","4769","383","17284","13179","11858","1321","25877","61633","0.4307","37.7","32278","70712","65832","982","807","Madison County, New York","36","053"
"5137","1977","851","2833","54302","16830","9923","9242","681","37472","25664","23473","2191","54302","65499","0.4348","37.5","69615","153085","130940","10702","4940","Schenectady County, New York","36","093"
"1900","394","27","51","23759","7339","4147","3934","213","16420","12343","10965","1378","23759","60524","0.4117","38.7","25797","57314","54422","501","406","Genesee County, New York","36","037"
"929","357","27","35","8919","3374","2055","1928","127","5545","4394","3906","488","8919","56563","0.4480","37.9","13870","24685","19871","277","192","Yates County, New York","36","123"
"2004","296","89","11","7164","2348","1408","1367","41","4816","3767","3383","384","7164","39837","0.4398","40.3","8331","18673","15240","190","144","Greene County, North Carolina","37","079"
"407","92","0","5","6344","2629","1413","1348","65","3715","2925","2683","242","6344","46103","0.4146","39.3","8831","14897","12860","115","166","Mitchell County, North Carolina","37","121"
"277","479","0","26","6133","2448","1343","1332","11","3685","2839","2654","185","6133","46519","0.4389","37.8","7304","13824","12262","259","21","Chowan County, North Carolina","37","041"
"125","101","7","17","4920","1921","1295","1259","36","2999","2281","2131","150","4920","37830","0.4494","38.7","8180","10896","9299","225","142","Alleghany County, North Carolina","37","005"
"3568","1787","133","11","32864","11203","7271","7016","255","21661","16595","15560","1035","32864","44511","0.4345","39.2","38067","81040","69773","751","523","Caldwell County, North Carolina","37","027"
"6366","3188","430","190","62319","19766","12373","11900","473","42553","33080","30188","2892","62319","52056","0.4623","39.2","69024","156051","130848","3739","3292","Catawba County, North Carolina","37","035"
"3100","2414","51","105","35638","12168","7795","7559","236","23470","17769","16553","1216","35638","42247","0.4721","38.6","43614","97038","83595","843","801","Cleveland County, North Carolina","37","045"
"3493","6061","1094","129","41226","13572","8707","8278","429","27654","20962","19510","1452","41226","52687","0.4538","40.3","47146","94907","81480","1768","1475","Craven County, North Carolina","37","049"
"1206","353","88","41","21151","7444","4471","4305","166","13707","10749","10103","646","21151","36866","0.4728","38.1","24990","52117","46135","389","207","Edgecombe County, North Carolina","37","065"
"3429","1004","139","61","21400","6486","4364","4196","168","14914","11707","10986","721","21400","55856","0.4298","39.7","24318","56456","49860","972","636","Granville County, North Carolina","37","077"
"7352","5383","739","86","45416","11094","6902","6679","223","34322","26888","25137","1751","45416","53554","0.4129","40.1","51828","126281","107495","2622","2060","Harnett County, North Carolina","37","085"
"3916","1780","540","111","17799","3453","2151","2046","105","14346","10726","10254","472","17799","48072","0.4300","40.8","20880","50096","41580","713","846","Hoke County, North Carolina","37","093"
"4044","3362","117","106","49221","20011","12773","12218","555","29210","21828","19831","1997","49221","55945","0.4372","38.5","57508","113773","95398","2816","2330","Henderson County, North Carolina","37","089"
"403","21","0","7","1947","743","371","349","22","1204","1055","1029","26","1947","39663","0.3824","40.1","3353","4626","3806","0","13","Hyde County, North Carolina","37","095"
"5549","5589","735","252","66369","19163","12988","12659","329","47206","37627","34788","2839","66369","60955","0.4700","39.4","74184","174408","150687","3763","4347","Iredell County, North Carolina","37","097"
"25705","45437","9422","16204","411097","82126","50808","48611","2197","328971","231963","202741","29222","411097","66641","0.4865","39.8","445287","1069233","833193","52196","59634","Mecklenburg County, North Carolina","37","119"
"1115","283","0","10","8547","3544","2214","2027","187","5003","3826","3583","243","8547","37146","0.4667","40.0","11666","19111","16328","78","84","Northampton County, North Carolina","37","131"
"14393","6583","409","1048","69799","16363","10162","9756","406","53436","38811","31359","7452","69799","47437","0.4874","37.8","79384","177203","153488","2995","2755","Pitt County, North Carolina","37","147"
"6672","2626","479","191","52843","16901","10726","10368","358","35942","28012","25476","2536","52843","49842","0.4452","38.8","61642","137980","118561","1342","1737","Rowan County, North Carolina","37","159"
"2034","376","237","13","16875","5508","3511","3379","132","11367","8554","7784","770","16875","40529","0.4880","38.4","20139","44052","37872","358","1075","Vance County, North Carolina","37","181"
"591","1333","28","19","12471","5728","3922","3756","166","6743","5223","4709","514","12471","41438","0.4151","38.6","18258","27657","23158","362","219","Cherokee County, North Carolina","37","039"
"308","1388","65","5","10522","3021","2150","2052","98","7501","6188","5415","773","10522","69964","0.3841","40.2","15806","25929","22095","248","136","Currituck County, North Carolina","37","053"
"8494","6570","493","512","76346","19137","14115","13710","405","57209","49909","47467","2442","76346","80033","0.4532","39.0","81056","229942","194078","9106","5962","Union County, North Carolina","37","179"
"1151","485","130","42","28753","10236","6139","5948","191","18517","14216","12961","1255","28753","44107","0.4669","39.6","33587","67621","58402","781","736","Wilkes County, North Carolina","37","193"
"5935","1812","454","215","37011","12120","7444","7063","381","24891","18840","17659","1181","37011","49537","0.4673","39.0","43045","92736","81251","1272","1212","Nash County, North Carolina","37","127"
"1855","409","27","0","14169","5069","3282","3170","112","9100","7422","7062","360","14169","48756","0.4661","39.8","16465","35908","31924","420","379","Alexander County, North Carolina","37","003"
"722","1388","221","9","15529","5347","3564","3392","172","10182","7666","6889","777","15529","59381","0.4317","39.5","34745","36022","30020","688","557","Dare County, North Carolina","37","055"
"971","307","23","11","7786","3384","1935","1845","90","4402","2909","2744","165","7786","36466","0.4987","38.5","12002","19012","16293","217","93","Warren County, North Carolina","37","185"
"2158","845","344","63","32014","10182","5671","5280","391","21832","16239","15085","1154","32014","43877","0.4679","38.8","36146","80405","67775","1818","1030","Wilson County, North Carolina","37","195"
"90","464","2","0","4638","1666","1103","1095","8","2972","2273","2110","163","4638","50750","0.4064","40.1","5380","11493","10671","56","10","Gates County, North Carolina","37","073"
"98","179","2","2","3393","1323","808","790","18","2070","1517","1388","129","3393","39571","0.4322","37.3","6050","8402","6983","12","12","Graham County, North Carolina","37","075"
"1122","593","49","0","8403","3235","1910","1818","92","5168","4126","3638","488","8403","45873","0.4640","37.7","10972","21263","18929","160","192","Madison County, North Carolina","37","115"
"534","173","20","19","5416","2557","1674","1616","58","2859","2072","1973","99","5416","46728","0.4823","37.9","7734","11977","10536","150","48","Pamlico County, North Carolina","37","137"
"767","664","12","9","9071","4261","2585","2474","111","4810","3411","3076","335","9071","48787","0.4468","38.4","11719","20272","17608","328","283","Polk County, North Carolina","37","149"
"5371","1767","123","206","56541","17525","10855","10547","308","39016","30370","27984","2386","56541","47288","0.4284","39.6","62411","141792","117681","2030","2660","Randolph County, North Carolina","37","151"
"1449","263","35","23","19578","6531","4051","3942","109","13047","10052","9406","646","19578","48054","0.4239","39.5","22245","45305","39930","192","108","Stokes County, North Carolina","37","169"
"339","264","17","0","4977","2054","1061","1022","39","2923","1822","1633","189","4977","35979","0.5099","38.2","6458","11759","10291","42","20","Washington County, North Carolina","37","187"
"106","410","0","0","4996","2253","1448","1423","25","2743","2131","2001","130","4996","42222","0.4813","38.7","7351","10922","9288","120","42","Clay County, North Carolina","37","043"
"8555","24614","3832","728","125427","28377","16735","16133","602","97050","67275","62052","5223","125427","46875","0.4465","40.4","146328","301989","256323","9566","6076","Cumberland County, North Carolina","37","051"
"18486","14114","2929","2988","203987","54692","33624","31990","1634","149295","109363","97256","12107","203987","53261","0.4848","38.5","228346","523811","433362","20957","19564","Guilford County, North Carolina","37","081"
"3484","1340","222","46","16773","5805","3556","3325","231","10968","8199","6639","1560","16773","47252","0.4462","35.5","27297","42722","36501","244","390","Jackson County, North Carolina","37","099"
"2148","1751","21","25","14697","4560","2727","2635","92","10137","7656","7194","462","14697","50558","0.4268","38.3","17157","37957","32596","557","269","Pasquotank County, North Carolina","37","139"
"2623","877","132","110","45927","14061","8638","8216","422","31866","23859","22492","1367","45927","34976","0.4882","38.6","53210","130886","110161","1050","1194","Robeson County, North Carolina","37","155"
"440","534","32","41","5620","1904","1158","1103","55","3716","2611","2512","99","5620","39317","0.4694","38.0","9022","14079","10853","112","88","Swain County, North Carolina","37","173"
"36999","36100","8473","5809","400172","83359","53962","51859","2103","316813","243783","216183","27600","400172","80591","0.4441","39.3","431552","1061002","863012","57052","51634","Wake County, North Carolina","37","183"
"1222","321","117","0","9521","3211","1732","1652","80","6310","4660","4157","503","9521","40213","0.4428","39.8","11622","23128","20208","199","161","Anson County, North Carolina","37","007"
"1361","468","62","6","18173","6204","4219","4074","145","11969","9587","8991","596","18173","43646","0.4423","39.0","21403","44328","38228","520","467","McDowell County, North Carolina","37","111"
"3988","1138","151","59","25381","7450","5065","4921","144","17931","14438","13498","940","25381","55193","0.4155","39.6","28507","65468","57024","1126","863","Franklin County, North Carolina","37","069"
"534","157","11","2","4045","1644","992","930","62","2401","1839","1714","125","4045","38158","0.4658","38.8","4985","9527","7928","81","16","Jones County, North Carolina","37","103"
"423","1961","68","32","15921","7002","4364","4155","209","8919","6799","6095","704","15921","45507","0.4675","37.9","25608","34625","29228","551","244","Macon County, North Carolina","37","113"
"6122","5334","150","202","56056","25590","18688","17929","759","30466","22311","20358","1953","56056","58236","0.4478","37.9","89368","130804","114281","2640","1094","Brunswick County, North Carolina","37","019"
"976","1025","204","24","14567","6778","4614","4424","190","7789","6070","5554","516","14567","50212","0.4426","36.5","19645","33285","28285","327","182","Transylvania County, North Carolina","37","175"
"636","454","54","20","19701","7789","4511","4398","113","11912","9090","8240","850","19701","45212","0.4826","38.1","26081","46791","40303","389","466","Beaufort County, North Carolina","37","013"
"2310","1221","80","41","21580","7939","4542","4442","100","13641","10272","9801","471","21580","37628","0.5036","39.3","26332","53109","45590","374","458","Columbus County, North Carolina","37","047"
"3432","1697","127","87","32894","10092","6866","6489","377","22802","18575","17183","1392","32894","57536","0.4576","39.8","35916","82293","72110","1930","1019","Lincoln County, North Carolina","37","109"
"1110","81","42","22","10195","3831","2306","2244","62","6364","4816","4544","272","10195","44146","0.4872","39.6","16258","26174","21328","552","836","Montgomery County, North Carolina","37","123"
"11195","6799","2429","5123","53376","13793","8739","8195","544","39583","28784","23799","4985","53376","71723","0.5186","36.2","58256","144191","118633","8139","7330","Orange County, North Carolina","37","135"
"1322","657","64","81","18380","5891","3287","3176","111","12489","9395","8607","788","18380","36148","0.4655","39.0","21585","43619","37692","547","287","Richmond County, North Carolina","37","153"
"2737","421","446","90","23416","7857","4621","4582","39","15559","11850","11123","727","23416","42151","0.4685","40.1","27726","62713","50021","959","1871","Sampson County, North Carolina","37","163"
"1275","952","162","86","29153","10177","5987","5875","112","18976","14780","13980","800","29153","43597","0.4845","39.4","34160","71158","60587","937","952","Surry County, North Carolina","37","171"
"1490","380","12","34","6551","2615","1736","1718","18","3936","2882","2601","281","6551","40340","0.4794","37.3","14225","14884","12301","95","126","Avery County, North Carolina","37","011"
"6824","8075","1265","778","107479","34646","20340","19035","1305","72833","51255","43572","7683","107479","52207","0.4697","37.9","123642","253150","216231","5596","4340","Buncombe County, North Carolina","37","021"
"9533","5284","350","870","72238","18074","12084","11665","419","54164","44109","41438","2671","72238","67328","0.4346","39.0","79437","205208","176000","7086","6375","Cabarrus County, North Carolina","37","025"
"661","266","22","0","9145","3306","2208","2086","122","5839","4684","4484","200","9145","45733","0.4342","38.5","10823","21730","19764","227","137","Caswell County, North Carolina","37","033"
"2062","940","88","41","16405","5992","3701","3526","175","10413","8665","8060","605","16405","60434","0.4395","39.1","18753","41936","36703","605","591","Davie County, North Carolina","37","059"
"5917","3028","202","307","66653","21151","13644","13164","480","45502","36106","32991","3115","66653","49546","0.4342","39.7","74839","163689","140522","2321","2274","Davidson County, North Carolina","37","057"
"1955","682","237","18","21466","7510","4542","4349","193","13956","10991","10155","836","21466","41764","0.4248","39.7","25958","58571","45590","831","2159","Duplin County, North Carolina","37","061"
"12189","13677","3811","5145","125953","27958","17152","16476","676","97995","66974","56306","10668","125953","60958","0.4681","39.1","136060","306362","242057","13254","14403","Durham County, North Carolina","37","063"
"1190","984","28","27","8845","3265","1788","1699","89","5580","4004","3720","284","8845","41028","0.4338","37.7","10660","22534","19586","253","130","Hertford County, North Carolina","37","091"
"2058","936","502","140","21894","6872","4391","4213","178","15022","11779","11010","769","21894","49994","0.4428","39.0","24509","59339","47967","1593","1549","Lee County, North Carolina","37","105"
"11407","7148","779","598","95638","27601","16231","15343","888","68037","47394","38768","8626","95638","54891","0.4910","37.6","111031","225237","194640","5441","2950","New Hanover County, North Carolina","37","129"
"4132","918","51","118","21740","7282","4810","4663","147","14458","10723","10013","710","21740","57240","0.4650","38.3","29030","58921","51672","725","500","Pender County, North Carolina","37","141"
"4157","3487","1033","258","48343","14781","8833","8509","324","33562","25798","23602","2196","48343","44416","0.4753","39.7","54291","119247","99628","1906","2677","Wayne County, North Carolina","37","191"
"1636","514","49","27","12922","4384","2612","2529","83","8538","6449","6064","385","12922","37238","0.4670","37.7","15312","33249","29028","235","171","Scotland County, North Carolina","37","165"
"6288","1717","94","437","21077","5824","3888","3674","214","15253","11384","7778","3606","21077","47526","0.5043","34.3","33751","54623","48447","655","559","Watauga County, North Carolina","37","189"
"1387","443","34","11","21017","7766","4621","4427","194","13251","9843","9253","590","21017","35502","0.4969","39.1","25939","49917","43081","374","282","Halifax County, North Carolina","37","083"
"6182","3263","633","139","64439","19637","11531","10996","535","44802","33953","30759","3194","64439","49688","0.4533","38.8","70644","162195","136679","3640","3699","Alamance County, North Carolina","37","001"
"430","36","0","6","1594","606","382","359","23","988","724","676","48","1594","35300","0.4250","40.0","2119","3356","2873","0","35","Tyrrell County, North Carolina","37","177"
"888","1964","369","196","12524","2667","1541","1459","82","9857","6920","5983","937","12524","72045","0.4533","43.6","14706","30776","27308","309","398","Stark County, North Dakota","38","089"
"164","20","0","0","1943","771","403","384","19","1172","811","748","63","1943","57582","0.4368","42.3","2422","3888","3739","9","4","Wells County, North Dakota","38","103"
"42","39","0","0","905","275","147","142","5","630","452","427","25","905","77232","0.4204","45.0","1405","2179","2018","23","21","Burke County, North Dakota","38","013"
"441","292","31","38","3360","814","544","518","26","2546","1786","1660","126","3360","72147","0.4700","43.0","5205","10258","8229","122","163","Mountrail County, North Dakota","38","061"
"1470","2666","225","48","14320","2362","1256","1222","34","11958","8683","7437","1246","14320","87161","0.4329","46.0","19322","34869","28590","602","860","Williams County, North Dakota","38","105"
"11","6","0","7","383","145","81","81","0","238","203","190","13","383","75208","0.4213","41.1","543","922","885","0","10","Billings County, North Dakota","38","007"
"68","208","10","6","1092","360","232","228","4","732","553","520","33","1092","54643","0.4577","43.2","1678","2463","2120","27","10","Kidder County, North Dakota","38","043"
"105","100","12","0","1737","634","382","377","5","1103","842","740","102","1737","64798","0.4922","42.8","2320","3696","3467","16","28","Cavalier County, North Dakota","38","019"
"138","110","4","0","1074","453","245","235","10","621","442","406","36","1074","50938","0.5088","47.2","1710","2295","2142","14","19","Grant County, North Dakota","38","037"
"212","89","7","7","2594","846","494","467","27","1748","1350","1244","106","2594","64179","0.4682","42.9","3171","5799","5470","44","22","McHenry County, North Dakota","38","049"
"55","8","0","2","777","266","162","155","7","511","357","339","18","777","70724","0.3728","45.5","1141","1744","1637","20","0","Steele County, North Dakota","38","091"
"221","32","11","9","2248","654","475","460","15","1594","1234","1143","91","2248","47667","0.5035","40.3","3059","6863","6089","10","8","Benson County, North Dakota","38","005"
"96","88","10","0","1822","697","451","422","29","1125","828","744","84","1822","60806","0.4713","43.1","2256","4051","3842","34","18","LaMoure County, North Dakota","38","045"
"1901","486","105","2","13565","3278","2029","1896","133","10287","8086","6778","1308","13565","70556","0.4432","41.2","15002","30273","28191","380","103","Morton County, North Dakota","38","059"
"146","202","37","8","1692","499","282","278","4","1193","892","837","55","1692","76719","0.4743","43.8","2621","4337","3440","32","51","Dunn County, North Dakota","38","025"
"89","96","4","2","1291","487","275","262","13","804","555","489","66","1291","52587","0.4457","45.2","1853","2488","2297","24","19","McIntosh County, North Dakota","38","051"
"113","73","18","3","1467","557","288","275","13","910","589","538","51","1467","52039","0.4620","42.4","1941","2824","2590","25","6","Nelson County, North Dakota","38","063"
"349","92","3","3","4608","1218","714","619","95","3390","2716","2548","168","4608","43158","0.5003","39.4","5582","14396","10723","19","26","Rolette County, North Dakota","38","079"
"291","193","9","7","4780","1498","860","813","47","3282","2348","2135","213","4780","55700","0.4619","41.3","5610","10570","9694","154","167","Walsh County, North Dakota","38","099"
"361","240","25","1","2992","1026","586","574","12","1966","1420","1258","162","2992","60381","0.4410","41.5","4432","6365","6014","59","67","Bottineau County, North Dakota","38","009"
"331","369","5","28","5074","1585","889","884","5","3489","2368","2024","344","5074","58365","0.4671","39.4","5961","10511","9651","46","171","Barnes County, North Dakota","38","003"
"2303","5980","520","388","30502","6036","3214","3072","142","24466","16887","13097","3790","30502","54051","0.4716","37.4","32961","68233","60420","1439","2057","Grand Forks County, North Dakota","38","035"
"424","1152","0","20","4302","796","447","405","42","3506","2689","2213","476","4302","77845","0.4667","45.2","6643","13212","10863","295","35","McKenzie County, North Dakota","38","053"
"541","64","6","0","4334","1479","911","872","39","2855","2149","2020","129","4334","68529","0.4077","41.7","6203","9429","8821","54","52","McLean County, North Dakota","38","055"
"358","68","16","0","1908","676","293","280","13","1232","952","802","150","1908","55660","0.4477","41.7","2268","3960","3818","8","11","Pierce County, North Dakota","38","069"
"137","29","0","6","950","285","175","168","7","665","513","460","53","950","73182","0.3508","43.1","1327","2372","2210","68","11","Renville County, North Dakota","38","075"
"85","45","2","6","1350","414","234","229","5","936","716","641","75","1350","62442","0.4332","42.7","1775","3080","2890","11","20","Bowman County, North Dakota","38","011"
"3759","1958","378","137","39507","10192","5675","5458","217","29315","21589","19127","2462","39507","71524","0.4381","39.7","42574","92801","85942","840","969","Burleigh County, North Dakota","38","015"
"35","34","0","6","849","320","199","188","11","529","371","337","34","849","59375","0.4238","45.9","1174","1796","1735","9","10","Logan County, North Dakota","38","047"
"134","0","3","0","738","285","204","202","2","453","383","381","2","738","78929","0.4064","43.5","992","1837","1686","21","0","Oliver County, North Dakota","38","065"
"843","884","166","18","8908","2711","1556","1461","95","6197","4061","3569","492","8908","57674","0.4496","39.6","10245","20070","18182","103","222","Stutsman County, North Dakota","38","093"
"573","225","150","109","4828","1397","798","761","37","3431","2275","1985","290","4828","58910","0.4775","40.9","5852","11155","10304","44","184","Ramsey County, North Dakota","38","071"
"128","48","7","6","1423","468","253","248","5","955","663","608","55","1423","61425","0.4066","41.6","1821","3166","2997","0","27","Foster County, North Dakota","38","031"
"95","13","0","2","1089","455","252","250","2","634","432","421","11","1089","53565","0.4489","41.0","1511","2312","2227","32","0","Griggs County, North Dakota","38","039"
"110","12","0","0","731","300","167","162","5","431","277","254","23","731","51055","0.4218","46.4","894","1409","1317","4","5","Sheridan County, North Dakota","38","083"
"2","0","0","0","326","137","88","84","4","189","149","148","1","326","63611","0.3988","44.6","477","742","735","0","2","Slope County, North Dakota","38","087"
"4771","722","187","237","20212","4769","3216","3093","123","15443","13068","12051","1017","20212","86715","0.4032","39.5","21258","53550","48810","1224","1207","Union County, Ohio","39","159"
"1207","211","1","35","10959","3429","2017","1935","82","7530","5883","5477","406","10959","42832","0.4694","38.6","12845","27712","25642","29","65","Pike County, Ohio","39","131"
"780","208","17","0","7705","2395","1480","1413","67","5310","4271","4019","252","7705","55330","0.4231","38.6","8759","18711","17427","160","48","Paulding County, Ohio","39","125"
"22483","20593","3978","13950","341873","88635","48803","46560","2243","253238","173889","150584","23305","341873","57212","0.5009","38.1","379402","805577","723116","19719","17117","Hamilton County, Ohio","39","061"
"37852","26768","9703","15789","511447","109682","64429","60904","3525","401765","282767","239079","43688","511447","61305","0.4653","38.5","555090","1282411","1072918","57235","54744","Franklin County, Ohio","39","049"
"3400","733","35","258","24737","7987","4807","4538","269","16750","12431","11306","1125","24737","47498","0.4524","38.9","27888","59823","55918","391","204","Marion County, Ohio","39","101"
"3209","907","227","50","36631","12332","7238","6898","340","24299","19210","17475","1735","36631","53243","0.4185","39.5","40217","91366","83208","545","490","Tuscarawas County, Ohio","39","157"
"4147","1136","175","136","43824","14116","8686","8421","265","29708","23093","21612","1481","43824","58300","0.4233","39.0","46648","114966","97862","1121","1039","Wayne County, Ohio","39","169"
"1762","485","69","22","17829","5387","3356","3227","129","12442","9832","9109","723","17829","54575","0.4099","39.4","20205","43017","39454","84","109","Brown County, Ohio","39","015"
"17101","9039","2184","957","139113","37559","23999","23196","803","101554","79963","72000","7963","139113","66117","0.4416","37.9","151887","376452","336747","10236","8409","Butler County, Ohio","39","017"
"339","137","17","2","6223","2133","1320","1246","74","4090","3123","2964","159","6223","49689","0.4172","40.2","8089","14944","13428","21","66","Harrison County, Ohio","39","067"
"2380","1541","135","202","23248","7085","4434","4191","243","16163","12977","11811","1166","23248","57749","0.3951","37.2","25820","60831","54331","309","335","Knox County, Ohio","39","083"
"8050","2392","189","179","64035","19294","12282","11741","541","44741","36687","33354","3333","64035","64589","0.4353","38.6","70821","172408","157614","2358","1392","Licking County, Ohio","39","089"
"5513","1500","132","485","48449","16468","9738","9270","468","31981","23934","21675","2259","48449","49547","0.4284","38.3","54190","114386","104671","1083","680","Richland County, Ohio","39","139"
"452","85","19","26","5140","1693","1028","1000","28","3447","2667","2456","211","5140","45673","0.4048","38.8","6278","13002","11800","54","25","Vinton County, Ohio","39","163"
"857","313","1","2","11298","3900","2453","2297","156","7398","5801","5334","467","11298","55267","0.4287","39.1","13607","27050","24649","117","8","Carroll County, Ohio","39","019"
"3226","1588","334","137","31937","8681","5031","4823","208","23256","17427","15118","2309","31937","58450","0.4399","38.7","34199","74933","69419","1137","1268","Hancock County, Ohio","39","063"
"8126","3405","323","344","78009","22297","14369","13860","509","55712","44297","40621","3676","78009","66968","0.4401","38.8","83205","202956","188576","2152","1962","Clermont County, Ohio","39","025"
"8240","2600","303","285","56339","16454","10420","10177","243","39885","32748","30168","2580","56339","67609","0.4206","38.8","61093","151573","138843","3055","1635","Fairfield County, Ohio","39","045"
"1320","517","29","53","15297","4731","3063","2953","110","10566","8540","7729","811","15297","59931","0.4036","39.4","16817","37869","35033","401","338","Defiance County, Ohio","39","039"
"2218","279","34","38","16772","5475","3270","3060","210","11297","8926","8161","765","16772","44169","0.4423","39.1","19351","42552","38524","284","127","Highland County, Ohio","39","071"
"1225","298","42","62","10992","3380","2124","2063","61","7612","6052","5602","450","10992","59695","0.3721","39.9","12089","26771","25329","234","150","Henry County, Ohio","39","069"
"1588","2055","73","131","27428","9950","5830","5557","273","17478","12899","11614","1285","27428","46581","0.4602","38.9","32510","65614","61078","554","284","Jefferson County, Ohio","39","081"
"9535","2426","912","466","61817","18002","11406","10791","615","43815","32715","28725","3990","61817","57618","0.4501","37.1","69138","161441","147842","1998","3357","Portage County, Ohio","39","133"
"1089","45","37","48","13327","3790","2385","2306","79","9537","7987","7457","530","13327","64822","0.3961","39.3","13936","33646","32373","180","82","Putnam County, Ohio","39","137"
"1743","948","24","145","25919","9350","5220","4955","265","16569","12143","11366","777","25919","50904","0.4530","37.2","32210","64197","60001","506","173","Belmont County, Ohio","39","013"
"2284","513","17","77","16528","5060","3028","2904","124","11468","8945","8204","741","16528","52815","0.4288","38.8","18163","41626","38741","265","272","Clinton County, Ohio","39","027"
"975","201","163","73","11773","3474","2099","2020","79","8299","6566","6050","516","11773","47308","0.4387","39.3","12783","28292","25950","181","150","Fayette County, Ohio","39","047"
"1875","193","57","76","13500","3919","2728","2483","245","9581","7872","7156","716","13500","50150","0.4298","39.2","15335","35777","33773","164","52","Perry County, Ohio","39","127"
"4744","523","78","31","19710","5947","3856","3679","177","13763","11385","10573","812","19710","63633","0.4096","39.8","21433","53404","49721","544","83","Pickaway County, Ohio","39","129"
"3978","547","98","81","15013","4638","2934","2614","320","10375","8623","7800","823","15013","68022","0.4037","39.1","16100","38883","35825","97","344","Madison County, Ohio","39","097"
"2907","488","165","95","33878","10721","6106","5856","250","23157","17693","16204","1489","33878","47254","0.4525","38.5","37940","85284","80208","308","361","Muskingum County, Ohio","39","119"
"1490","533","106","129","23574","7387","4453","4219","234","16187","12614","11424","1190","23574","54089","0.4041","38.8","26318","58105","54818","473","142","Sandusky County, Ohio","39","143"
"885","396","38","28","11544","3594","2205","2122","83","7950","6360","6037","323","11544","54254","0.4058","39.0","12707","27993","26683","45","32","Van Wert County, Ohio","39","161"
"987","1700","119","138","25197","8725","5327","5154","173","16472","12262","11243","1019","25197","50021","0.4578","38.6","28218","59750","54792","293","353","Washington County, Ohio","39","167"
"2056","332","14","78","18888","5725","3392","3258","134","13163","10572","9828","744","18888","64074","0.3962","39.9","19902","45184","43201","198","148","Auglaize County, Ohio","39","011"
"1276","663","88","114","20861","6840","4048","3818","230","14021","11403","10518","885","20861","55620","0.4106","39.4","22903","50918","47687","269","83","Darke County, Ohio","39","037"
"1371","554","18","170","18051","6999","4261","4083","178","11052","8610","7829","781","18051","59099","0.4321","39.5","28479","40182","38118","298","103","Ottawa County, Ohio","39","123"
"1515","642","71","0","11678","3530","2163","2071","92","8148","6441","5777","664","11678","50506","0.4029","37.6","13194","31239","27440","68","418","Hardin County, Ohio","39","065"
"1016","328","75","38","12780","3803","2408","2357","51","8977","7188","6854","334","12780","47550","0.4255","38.8","14852","32115","29217","120","136","Jackson County, Ohio","39","079"
"1724","832","45","92","22935","6991","4098","3877","221","15944","12658","11421","1237","22935","52560","0.4093","39.3","25307","57776","52935","359","414","Huron County, Ohio","39","077"
"9336","2185","458","297","22557","5817","3523","3349","174","16740","11990","9041","2949","22557","40905","0.5025","33.2","26689","65217","58713","729","1769","Athens County, Ohio","39","009"
"464","179","38","109","10673","3505","2017","1932","85","7168","5894","5479","415","10673","39079","0.4815","38.7","12937","27497","25283","74","50","Adams County, Ohio","39","001"
"6979","2058","199","289","69007","21374","13283","12937","346","47633","38083","35678","2405","69007","76600","0.4137","38.7","72430","176768","164960","3574","1250","Medina County, Ohio","39","103"
"9475","9211","1264","3430","179930","49319","27936","26451","1485","130611","91668","80662","11006","179930","48736","0.4871","38.2","203330","426306","387179","7850","5857","Lucas County, Ohio","39","095"
"1071","143","1","26","5067","2547","1433","1391","42","2520","1983","1789","194","5067","46897","0.4579","32.0","6160","12071","11316","9","0","Noble County, Ohio","39","121"
"","","","1891","67476","26184","17276","16505","771","41292","31699","29740","1959","67476","26420","0.4931","35.5","83204","173096","154899","2867","2341","Bayamón Municipio, Puerto Rico","72","021"
"","","","128","14643","4983","3413","3300","113","9660","7612","7097","515","14643","21267","0.5458","35.8","17694","45414","39566","472","655","Canóvanas Municipio, Puerto Rico","72","029"
"","","","59","5565","2466","1454","1422","32","3099","2525","2337","188","5565","13733","0.5113","35.4","7328","19213","18193","24","79","Comerío Municipio, Puerto Rico","72","045"
"","","","25","15408","5491","3924","3820","104","9917","8158","7637","521","15408","20657","0.5044","33.1","18644","45976","43472","39","113","Juana Díaz Municipio, Puerto Rico","72","075"
"","","","1","2708","1146","802","782","20","1562","1283","1121","162","2708","14135","0.5244","33.2","3895","8286","8086","19","0","Las Marías Municipio, Puerto Rico","72","083"
"","","","95","10535","4039","2920","2824","96","6496","5377","5147","230","10535","15140","0.5241","35.1","12836","33262","31456","5","38","Corozal Municipio, Puerto Rico","72","047"
"","","","0","3833","1706","1270","1213","57","2127","1712","1591","121","3833","20844","0.4151","35.1","5209","10770","10095","37","0","Maunabo Municipio, Puerto Rico","72","095"
"","","","105","52042","20873","13250","12653","597","31169","23417","22140","1277","52042","17069","0.5720","34.0","65901","137042","128148","706","816","Ponce Municipio, Puerto Rico","72","113"
"","","","367","22138","6756","4842","4743","99","15382","12909","12513","396","22138","28834","0.5014","36.9","26205","72714","67208","488","242","Toa Alta Municipio, Puerto Rico","72","135"
"","","","546","27400","10165","6678","6429","249","17235","12799","12059","740","27400","25105","0.4790","35.7","34692","77505","70451","859","737","Toa Baja Municipio, Puerto Rico","72","137"
"","","","0","2258","1117","658","570","88","1141","761","633","128","2258","14936","0.4541","33.7","4908","8642","7593","0","9","Vieques Municipio, Puerto Rico","72","147"
"","","","0","11541","4574","3086","2802","284","6967","5174","4774","400","11541","16295","0.5098","35.6","14509","33455","31694","36","40","Yabucoa Municipio, Puerto Rico","72","151"
"","","","73","12830","4937","3527","3311","216","7893","6393","6095","298","12830","16738","0.5011","33.1","17704","37940","35500","59","105","Aguada Municipio, Puerto Rico","72","003"
"","","","682","48184","17526","11472","10847","625","30658","24022","21739","2283","48184","25136","0.5277","36.5","57542","128334","117912","1309","791","Caguas Municipio, Puerto Rico","72","025"
"","","","75","12942","4730","3058","3001","57","8212","6706","6338","368","12942","19726","0.5089","35.2","15834","39493","37304","144","124","Cidra Municipio, Puerto Rico","72","041"
"","","","9","13104","4714","3062","2956","106","8390","6486","6048","438","13104","19692","0.5038","35.1","16204","38857","37068","184","174","Coamo Municipio, Puerto Rico","72","043"
"","","","37","11602","4115","2944","2857","87","7487","6077","5552","525","11602","30732","0.5472","36.7","15847","36697","34202","251","284","Dorado Municipio, Puerto Rico","72","051"
"","","","21","6582","2676","1930","1778","152","3906","2928","2775","153","6582","21850","0.4744","34.8","10469","18106","16413","195","116","Luquillo Municipio, Puerto Rico","72","089"
"","","","1","8720","3076","2216","2095","121","5644","4640","4504","136","8720","17036","0.4964","35.2","10753","28256","27042","61","46","Barranquitas Municipio, Puerto Rico","72","019"
"","","","34","6759","2466","1759","1702","57","4293","3512","3327","185","6759","15099","0.5376","35.0","8817","20886","20078","27","110","Orocovis Municipio, Puerto Rico","72","107"
"","","","114","13772","5044","3175","3032","143","8728","6777","6403","374","13772","19380","0.4967","35.9","16202","37153","34659","316","112","San Lorenzo Municipio, Puerto Rico","72","129"
"","","","35","4224","1933","1136","1112","24","2291","1797","1660","137","4224","18309","0.5156","33.5","7404","11505","10602","165","80","Ceiba Municipio, Puerto Rico","72","037"
"","","","10","5831","2330","1616","1535","81","3501","3023","2895","128","5831","16867","0.5226","34.4","7267","16498","15686","31","0","Ciales Municipio, Puerto Rico","72","039"
"","","","61","14670","5510","3716","3613","103","9160","7037","6721","316","14670","16540","0.5091","33.9","20258","41431","38505","209","358","Isabela Municipio, Puerto Rico","72","071"
"","","","17","4837","1873","1325","1325","0","2964","2427","2355","72","4837","14808","0.5037","35.5","6169","14258","13218","15","9","Jayuya Municipio, Puerto Rico","72","073"
"","","","32","9967","3813","2610","2534","76","6154","5047","4914","133","9967","16532","0.5357","33.3","12314","25481","23945","95","20","Lares Municipio, Puerto Rico","72","081"
"","","","7438","142699","53273","29693","27936","1757","89426","58405","53181","5224","142699","22710","0.6194","36.0","191126","331817","271192","17091","11644","San Juan Municipio, Puerto Rico","72","127"
"","","","164","11918","4398","3050","3023","27","7520","6175","5946","229","11918","20048","0.5383","35.0","15935","36526","34143","180","201","Vega Alta Municipio, Puerto Rico","72","143"
"","","","0","1846","812","573","508","65","1034","906","839","67","1846","12441","0.4841","30.6","2592","6075","5668","0","190","Maricao Municipio, Puerto Rico","72","093"
"2633","811","281","107","21648","6609","3980","3826","154","15039","11571","10313","1258","21648","52500","0.4276","37.8","24132","54427","50953","434","453","Seneca County, Ohio","39","147"
"8830","3826","633","2179","153460","49323","30069","28435","1634","104137","77561","70351","7210","153460","53860","0.4409","38.4","166725","367654","340561","4245","1896","Stark County, Ohio","39","151"
"1483","196","44","58","14476","4914","2879","2708","171","9562","7594","7168","426","14476","46606","0.4235","39.4","16455","36166","32247","160","52","Coshocton County, Ohio","39","031"
"9971","3709","1120","258","69985","17989","11787","11469","318","51996","44599","42267","2332","69985","106908","0.4250","39.0","73234","200222","178822","7847","6124","Delaware County, Ohio","39","041"
"3218","791","314","185","35298","12243","8485","8099","386","23055","19225","17823","1402","35298","82303","0.4647","38.9","37179","93087","82694","1619","584","Geauga County, Ohio","39","055"
"994","85","36","105","11286","3594","2223","2103","120","7692","6273","5830","443","11286","52363","0.4097","37.6","13410","27858","26117","84","70","Hocking County, Ohio","39","073"
"5285","2616","780","1127","96361","31343","19594","18553","1041","65018","47824","42888","4936","96361","64466","0.4149","38.8","102964","227907","206657","6829","3706","Lake County, Ohio","39","085"
"3654","647","67","256","28802","8639","5299","5076","223","20163","16063","14742","1321","28802","51092","0.4463","37.7","32025","71236","66386","380","287","Ross County, Ohio","39","141"
"22828","20552","7517","26640","540965","163352","86365","81369","4996","377613","249490","220492","28998","540965","50366","0.5113","38.2","618395","1232447","1081276","52962","31268","Cuyahoga County, Ohio","39","035"
"1256","86","31","53","12342","3502","2488","2308","180","8840","7719","7494","225","12342","63753","0.4183","40.6","13604","43079","25351","162","26","Holmes County, Ohio","39","075"
"4039","1621","440","131","41043","13327","8070","7742","328","27716","21149","18830","2319","41043","61041","0.4270","39.0","44320","104310","96684","959","795","Miami County, Ohio","39","109"
"147","71","16","28","5745","2238","1317","1283","34","3507","2607","2494","113","5745","45289","0.4689","40.1","7489","13805","12802","71","13","Monroe County, Ohio","39","111"
"4085","1832","246","480","85621","30121","17961","17186","775","55500","40247","36451","3796","85621","47280","0.4529","38.1","95687","196897","180534","2400","533","Trumbull County, Ohio","39","155"
"9904","2597","775","112","50589","13207","8215","7807","408","37382","27526","22864","4662","50589","62390","0.4477","36.6","53962","128845","119910","1768","1772","Wood County, Ohio","39","173"
"2810","630","132","99","20417","6523","4210","4031","179","13894","10593","9425","1168","20417","52823","0.4143","37.7","22312","52915","47566","410","242","Ashland County, Ohio","39","005"
"305","41","0","0","1689","561","377","377","0","1128","862","831","31","1689","52428","0.4700","42.2","2448","4826","3977","3","61","Dewey County, Oklahoma","40","043"
"171","103","12","0","1258","464","233","233","0","794","594","574","20","1258","46154","0.4102","44.1","1885","3730","3049","29","194","Harper County, Oklahoma","40","059"
"2690","1206","128","66","15512","4678","2952","2845","107","10834","9030","8484","546","15512","65357","0.4628","39.2","17497","46284","39808","573","332","Logan County, Oklahoma","40","083"
"18486","17343","3450","1881","252661","64747","37987","36170","1817","187914","137768","123318","14450","252661","55517","0.4859","39.6","282675","641435","516899","16469","18307","Tulsa County, Oklahoma","40","143"
"1819","1879","149","32","20455","6955","4048","3895","153","13500","10579","9854","725","20455","54997","0.4708","39.9","23740","51473","42634","733","1092","Washington County, Oklahoma","40","147"
"72","22","3","0","1113","335","224","212","12","778","603","547","56","1113","48344","0.4537","41.7","1529","2618","2139","65","16","Harmon County, Oklahoma","40","057"
"609","108","12","0","4931","1730","1161","1088","73","3201","2568","2408","160","4931","42348","0.4466","40.4","6179","12623","10249","36","79","Haskell County, Oklahoma","40","061"
"2028","573","57","72","14724","5204","3042","2883","159","9520","7488","6828","660","14724","42998","0.4702","38.9","17910","38077","31447","152","176","Okmulgee County, Oklahoma","40","111"
"2495","694","34","40","18263","6383","3954","3819","135","11880","9320","8863","457","18263","49103","0.4431","39.7","21790","45806","39630","343","139","Osage County, Oklahoma","40","113"
"303","267","0","0","2371","846","477","452","25","1525","1247","1168","79","2371","39895","0.5181","42.2","3398","6013","4829","71","46","Jefferson County, Oklahoma","40","067"
"1615","1843","619","91","23541","6861","3821","3687","134","16680","12840","11816","1024","23541","54006","0.4467","41.9","26803","59739","47841","1167","1951","Garfield County, Oklahoma","40","047"
"570","180","19","6","10447","3490","2117","2027","90","6957","5442","5096","346","10447","47125","0.4435","42.2","12882","27584","23026","276","179","Garvin County, Oklahoma","40","049"
"2259","987","27","16","17816","6221","3771","3594","177","11595","8887","8182","705","17816","46784","0.4578","41.7","23095","42174","35057","212","119","Pittsburg County, Oklahoma","40","121"
"1721","558","78","123","14278","4215","2727","2647","80","10063","7539","6691","848","14278","50392","0.4503","38.9","16881","37859","31158","297","228","Pontotoc County, Oklahoma","40","123"
"135","169","0","2","1377","524","311","308","3","853","659","585","74","1377","51302","0.5526","41.9","1907","3652","3140","16","10","Roger Mills County, Oklahoma","40","129"
"1148","430","120","0","7495","2139","1293","1271","22","5356","4268","4053","215","7495","60147","0.4279","40.5","9039","19708","16459","277","655","Woodward County, Oklahoma","40","153"
"2715","849","40","46","16665","5275","3132","3009","123","11390","8400","7598","802","16665","42774","0.4729","38.1","22157","48254","37208","251","622","Cherokee County, Oklahoma","40","021"
"1147","1365","12","17","16739","7099","4653","4466","187","9640","7445","6847","598","16739","41696","0.4632","39.3","25474","42058","33593","334","245","Delaware County, Oklahoma","40","041"
"273","74","0","0","1614","626","336","317","19","988","730","688","42","1614","53245","0.4387","41.3","2274","3959","3341","35","41","Ellis County, Oklahoma","40","045"
"2223","775","120","31","19857","5782","3925","3762","163","14075","11653","10937","716","19857","60875","0.4475","40.9","22845","54542","47505","411","359","Grady County, Oklahoma","40","051"
"7473","3644","1041","277","30788","7071","4440","4314","126","23717","16682","12429","4253","30788","41603","0.5208","36.4","36325","80350","65868","1276","3800","Payne County, Oklahoma","40","119"
"3590","1307","32","20","25917","8091","4853","4640","213","17826","14140","13263","877","25917","49250","0.4498","38.7","29803","70235","59165","511","341","Pottawatomie County, Oklahoma","40","125"
"2417","672","45","57","26427","8366","5457","5294","163","18061","14358","13448","910","26427","51318","0.4483","40.2","30421","70625","61175","486","421","Creek County, Oklahoma","40","037"
"359","485","84","32","2807","1033","634","608","26","1774","1452","1271","181","2807","42280","0.4430","40.4","4007","7070","5785","65","138","Tillman County, Oklahoma","40","141"
"615","162","13","0","4224","1317","784","770","14","2907","2322","2171","151","4224","53274","0.4259","41.7","5404","10923","9411","53","123","Washita County, Oklahoma","40","149"
"324","112","4","0","2195","784","514","508","6","1411","1157","1100","57","2195","50885","0.4360","40.0","2998","5729","4854","18","13","Cotton County, Oklahoma","40","033"
"481","139","15","0","3571","1225","708","651","57","2346","1745","1641","104","3571","38019","0.4592","41.2","5148","8687","7341","61","69","Kiowa County, Oklahoma","40","075"
"1197","1503","61","12","18261","6164","3820","3670","150","12097","9754","9035","719","18261","40677","0.4497","40.2","22074","48819","39422","266","346","Le Flore County, Oklahoma","40","079"
"330","373","25","42","12646","4220","2499","2381","118","8426","6710","6414","296","12646","37061","0.4557","41.7","15682","32639","24813","321","265","McCurtain County, Oklahoma","40","089"
"399","115","12","0","3123","1057","640","603","37","2066","1697","1607","90","3123","54332","0.4308","42.5","3684","7586","6427","217","161","Major County, Oklahoma","40","093"
"1249","422","43","37","15983","5137","3203","3179","24","10846","8931","8229","702","15983","50345","0.4319","40.2","19524","40611","33979","162","202","Mayes County, Oklahoma","40","097"
"25724","20260","4159","2060","301570","75806","44482","42451","2031","225764","163081","143895","19186","301570","54520","0.4911","39.4","338682","775218","619069","23139","24390","Oklahoma County, Oklahoma","40","109"
"1727","1066","73","14","10653","2686","1478","1471","7","7967","6071","5279","792","10653","49900","0.4678","39.5","12636","28625","23251","770","781","Custer County, Oklahoma","40","039"
"273","156","0","4","3268","1284","833","765","68","1984","1576","1502","74","3268","49399","0.4077","40.8","4588","9983","8086","226","238","Love County, Oklahoma","40","085"
"1823","442","36","100","7578","2188","1405","1348","57","5390","4223","3915","308","7578","50721","0.4523","41.9","10046","20219","16916","392","119","Beckham County, Oklahoma","40","009"
"462","503","7","50","5971","2135","1226","1188","38","3836","2810","2641","169","5971","34489","0.4877","40.2","7613","14624","11300","47","46","Choctaw County, Oklahoma","40","023"
"879","1635","63","3","9762","2539","1638","1580","58","7223","5285","4876","409","9762","49703","0.4397","40.2","12116","23516","19538","419","543","Jackson County, Oklahoma","40","065"
"1269","249","33","8","12763","4194","2528","2476","52","8569","6737","6367","370","12763","50671","0.4446","40.4","15386","34521","29458","120","160","Lincoln County, Oklahoma","40","081"
"894","128","11","14","6179","2063","1405","1353","52","4116","3263","3109","154","6179","48009","0.4356","40.9","7832","16246","13646","56","29","Pawnee County, Oklahoma","40","117"
"1115","414","18","23","9317","3091","1860","1756","104","6226","4899","4612","287","9317","39373","0.4471","40.4","11731","24405","19386","123","152","Seminole County, Oklahoma","40","133"
"33","55","1","0","977","381","189","184","5","596","439","415","24","977","46328","0.4812","43.7","1581","2157","1731","50","56","Cimarron County, Oklahoma","40","025"
"527","346","48","1","3898","1256","723","692","31","2642","1943","1824","119","3898","45792","0.4559","43.3","5052","8055","6969","56","65","Blaine County, Oklahoma","40","011"
"222","99","0","3","2227","818","455","448","7","1409","1088","1010","78","2227","40938","0.4976","42.4","2814","5511","4193","31","7","Coal County, Oklahoma","40","029"
"205","76","0","0","1736","579","363","356","7","1157","828","787","41","1736","57727","0.3910","42.8","2469","4292","3839","20","8","Grant County, Oklahoma","40","053"
"221","150","105","3","5609","1608","1035","972","63","4001","3186","3007","179","5609","57777","0.4798","42.6","6533","15525","12654","236","510","Kingfisher County, Oklahoma","40","073"
"2981","574","85","0","14428","4246","2710","2604","106","10182","8757","8406","351","14428","67662","0.4221","41.1","15593","38857","33484","358","470","McClain County, Oklahoma","40","087"
"764","442","2","28","6195","2514","1635","1587","48","3681","3009","2782","227","6195","45746","0.4354","40.9","10281","16305","12762","168","537","Marshall County, Oklahoma","40","095"
"730","212","0","31","4515","1444","935","910","25","3071","2449","2333","116","4515","56117","0.4264","41.4","5349","11247","10167","23","13","Noble County, Oklahoma","40","103"
"348","144","13","9","4099","1316","893","876","17","2783","2025","1957","68","4099","43145","0.4166","40.3","4874","10156","8325","19","52","Nowata County, Oklahoma","40","105"
"5173","1312","155","11","34755","9696","6563","6344","219","25059","20649","19413","1236","34755","65434","0.4233","39.9","37994","90246","78874","1073","595","Rogers County, Oklahoma","40","131"
"980","1220","31","30","15474","5223","3425","3360","65","10251","8179","7713","466","15474","40351","0.4374","39.2","19289","41268","32971","178","265","Sequoyah County, Oklahoma","40","135"
"358","85","12","4","1870","639","389","387","2","1231","965","925","40","1870","61852","0.4579","41.4","2728","4745","4096","53","10","Alfalfa County, Oklahoma","40","003"
"802","368","7","0","3281","965","573","539","34","2316","1661","1391","270","3281","54282","0.4382","38.7","4424","8464","7430","82","9","Woods County, Oklahoma","40","151"
"17789","9286","1389","449","106172","25553","15989","15397","592","80619","62768","53961","8807","106172","64016","0.4344","38.2","114796","273487","233022","8111","6364","Cleveland County, Oklahoma","40","027"
"758","63","29","5","3976","1382","875","841","34","2594","1994","1901","93","3976","38411","0.4585","40.5","5357","11045","8359","54","24","Okfuskee County, Oklahoma","40","107"
"1185","128","8","3","5284","1830","1175","1143","32","3454","2693","2513","180","5284","39316","0.4692","40.2","6367","12337","10085","73","78","Atoka County, Oklahoma","40","005"
"1009","931","142","31","10708","3760","2307","2172","135","6948","5765","4860","905","10708","52171","0.4372","38.1","11829","26078","23704","232","345","Union County, Oregon","41","061"
"12612","7114","1330","2596","118038","36147","22708","21188","1520","81891","65642","59142","6500","118038","59625","0.4265","37.9","126210","333411","275672","13042","17892","Marion County, Oregon","41","047"
"2673","3960","138","121","45456","19278","12661","11820","841","26178","20547","18178","2369","45456","47267","0.4397","38.1","50332","108435","99089","1558","998","Douglas County, Oregon","41","019"
"1966","537","73","84","8094","3075","2212","2019","193","5019","4034","3615","419","8094","53277","0.4364","38.9","10092","22539","19271","598","571","Jefferson County, Oregon","41","031"
"6191","1845","324","255","30305","10132","6546","6193","353","20173","16533","14536","1997","30305","62691","0.4292","37.1","32104","82617","72967","2435","2827","Polk County, Oregon","41","053"
"5985","7856","901","236","74397","24785","16940","15688","1252","49612","39531","34299","5232","74397","67043","0.4431","37.7","88714","185581","164956","3751","2702","Deschutes County, Oregon","41","017"
"6165","2331","375","92","47762","16022","10435","9766","669","31740","25436","22606","2830","47762","55893","0.4213","38.3","50416","124300","111132","1974","2309","Linn County, Oregon","41","043"
"4824","2633","299","347","36808","11881","7771","7228","543","24927","20457","18490","1967","36808","63902","0.4461","37.3","39069","102460","90361","3047","2832","Yamhill County, Oregon","41","071"
"1093","534","0","7","6921","2897","1644","1515","129","4024","2996","2714","282","6921","45998","0.4528","38.2","9027","15518","14003","93","117","Baker County, Oregon","41","001"
"2351","2920","108","150","27886","9854","6139","5595","544","18032","13860","12075","1785","27886","46491","0.4485","39.2","33555","66285","58052","1467","1158","Klamath County, Oregon","41","035"
"1928","1780","154","203","21298","9546","5985","5446","539","11752","8321","7111","1210","21298","47882","0.4455","37.6","31525","48167","41928","927","800","Lincoln County, Oregon","41","041"
"7626","4219","1271","1069","35718","9861","6344","6045","299","25857","19812","14485","5327","35718","62077","0.4801","34.6","38399","90848","78269","2421","5495","Benton County, Oregon","41","003"
"1157","771","43","0","9588","3953","2729","2627","102","5635","4327","3838","489","9588","49006","0.4187","37.3","10793","22949","20821","323","199","Crook County, Oregon","41","013"
"69","33","2","0","748","295","194","174","20","453","302","271","31","748","51071","0.4464","40.4","918","1640","1475","2","16","Sherman County, Oregon","41","055"
"456","222","29","0","3244","1169","816","663","153","2075","1731","1561","170","3244","40735","0.4314","39.7","3888","7157","6669","26","43","Harney County, Oregon","41","025"
"1488","1416","74","20","10062","3388","2089","1979","110","6674","5082","4718","364","10062","43313","0.4414","38.5","11888","26897","22686","573","1040","Malheur County, Oregon","41","045"
"138","252","8","0","3214","1330","868","853","15","1884","1390","1226","164","3214","51224","0.4551","37.6","4215","6903","6448","93","47","Wallowa County, Oregon","41","063"
"97","33","0","0","640","338","217","197","20","302","228","199","29","640","40926","0.3839","39.1","970","1415","1321","3","17","Wheeler County, Oregon","41","069"
"529","464","75","7","4108","1221","899","876","23","2887","2494","2249","245","4108","54269","0.3983","42.0","4633","11293","8730","416","1071","Morrow County, Oregon","41","049"
"1629","2354","265","130","27025","11513","6789","6237","552","15512","11593","10211","1382","27025","45051","0.4612","37.3","31124","62871","56696","1007","805","Coos County, Oregon","41","011"
"649","1363","48","15","10546","5450","3328","2966","362","5096","3738","3327","411","10546","48440","0.4439","37.6","12948","22491","20520","498","103","Curry County, Oregon","41","015"
"59","28","6","0","842","341","235","214","21","501","309","279","30","842","47500","0.3769","40.9","1130","1868","1712","10","16","Gilliam County, Oregon","41","021"
"280","684","167","34","8600","2626","1531","1418","113","5974","4736","4304","432","8600","65679","0.4357","38.3","9914","23119","18385","914","1878","Hood River County, Oregon","41","027"
"519","262","88","6","3515","1472","834","791","43","2043","1573","1422","151","3515","37898","0.4506","38.7","4507","7269","6424","109","181","Lake County, Oregon","41","037"
"22562","32811","6969","50977","326229","76749","44113","40171","3942","249480","176190","135989","40201","326229","69176","0.4701","37.7","348029","799365","653270","50512","42208","Multnomah County, Oregon","41","051"
"1211","2395","19","702","22119","8209","5441","5098","343","13910","11050","10370","680","22119","65928","0.4291","38.4","38940","55051","47915","3261","778","Pike County, Pennsylvania","42","103"
"1194","641","95","23","14794","5025","3149","3023","126","9769","8047","7505","542","14794","58997","0.4132","37.9","16442","40150","35431","282","207","Snyder County, Pennsylvania","42","109"
"783","691","26","19","17235","6554","4172","3939","233","10681","8336","7617","719","17235","54966","0.4463","40.0","23319","40685","37401","443","161","Susquehanna County, Pennsylvania","42","115"
"2436","1256","92","182","35164","12225","7515","7147","368","22939","17673","15949","1724","35164","50304","0.4317","38.8","44914","84149","76000","651","352","Crawford County, Pennsylvania","42","039"
"5696","5482","1164","2302","110318","33786","19488","18541","947","76532","57151","49952","7199","110318","51529","0.4568","37.4","121362","267417","244521","5344","5330","Erie County, Pennsylvania","42","049"
"410","209","6","0","5989","2163","1334","1278","56","3826","2940","2742","198","5989","53476","0.4060","38.8","7257","14479","13495","64","30","Fulton County, Pennsylvania","42","057"
"789","172","157","20","9372","3123","1936","1814","122","6249","5001","4596","405","9372","53879","0.4075","39.1","11218","24386","21265","267","185","Juniata County, Pennsylvania","42","067"
"2877","1063","163","302","58749","20076","11825","11311","514","38673","29472","27050","2422","58749","52280","0.4303","39.3","69870","135532","126187","1448","834","Schuylkill County, Pennsylvania","42","107"
"952","374","18","62","10790","3885","2488","2324","164","6905","5370","4864","506","10790","59415","0.4101","38.7","13458","27074","25756","190","64","Wyoming County, Pennsylvania","42","131"
"3120","2710","180","203","39345","13915","9031","8661","370","25430","20418","18987","1431","39345","67253","0.3945","38.4","42292","101190","92124","1489","1932","Adams County, Pennsylvania","42","001"
"1624","391","43","198","28137","10312","6283","5910","373","17825","13808","12908","900","28137","51410","0.4181","39.6","32853","65307","62303","193","71","Armstrong County, Pennsylvania","42","005"
"1926","364","100","37","14690","4983","2862","2669","193","9707","7635","6627","1008","14690","50923","0.4339","38.4","19250","38358","35096","385","148","Clinton County, Pennsylvania","42","035"
"1788","924","122","150","26043","9373","5739","5358","381","16670","13212","11486","1726","26043","57006","0.4188","39.3","34795","63019","58805","1116","478","Carbon County, Pennsylvania","42","025"
"11971","6901","2587","4342","58201","15143","9363","9043","320","43058","31210","23827","7383","58201","60403","0.4720","36.1","66705","156625","134547","3833","9404","Centre County, Pennsylvania","42","027"
"3094","823","76","80","39075","13788","7819","7430","389","25287","19330","17645","1685","39075","48671","0.4338","38.6","45465","87881","82854","625","562","Northumberland County, Pennsylvania","42","097"
"9388","7882","1291","2365","114185","38468","24477","23567","910","75717","60831","54414","6417","114185","70471","0.4369","38.5","123159","300186","265727","13375","7339","Northampton County, Pennsylvania","42","095"
"1359","545","63","78","22050","7793","4746","4476","270","14257","10814","9875","939","22050","49945","0.4237","38.7","27620","51120","47715","219","76","Venango County, Pennsylvania","42","121"
"4753","2515","316","1696","71167","25190","14464","13843","621","45977","34661","31397","3264","71167","57807","0.4250","38.5","79463","164403","155367","2032","793","Beaver County, Pennsylvania","42","007"
"4903","4860","963","897","87161","29059","16636","15874","762","58102","42368","37481","4887","87161","52821","0.4624","38.1","100262","206790","187897","5107","4513","Lackawanna County, Pennsylvania","42","069"
"874","1309","105","150","17147","5605","3450","3273","177","11542","8573","7587","986","17147","48647","0.4554","38.5","21275","39392","37293","274","282","McKean County, Pennsylvania","42","083"
"3154","1269","457","412","54837","19666","11235","10647","588","35171","26490","23853","2637","54837","47364","0.4681","39.3","63795","127745","120062","841","853","Fayette County, Pennsylvania","42","051"
"25933","13538","3981","22501","316206","98893","60592","58404","2188","217313","173686","159297","14389","316206","91546","0.4671","39.0","334387","809623","702463","49043","29351","Montgomery County, Pennsylvania","42","091"
"2766","522","184","91","31248","11240","6709","6410","299","20008","15497","14095","1402","31248","49015","0.4222","38.5","39248","74436","70228","204","204","Clearfield County, Pennsylvania","42","033"
"5485","1918","1093","593","53579","18001","11220","10750","470","35578","28432","25841","2591","53579","60281","0.4034","38.9","57609","138015","121157","2986","1937","Lebanon County, Pennsylvania","42","075"
"3119","1443","404","572","45608","14634","9192","8733","459","30974","23198","21007","2191","45608","54241","0.4278","38.9","53428","111088","103017","1092","964","Lycoming County, Pennsylvania","42","081"
"961","270","34","5","7404","2427","1310","1268","42","4977","3744","3415","329","7404","58333","0.4893","39.0","8200","17584","16026","378","251","Montour County, Pennsylvania","42","093"
"575","680","24","87","17115","6146","3759","3583","176","10969","8137","7496","641","17115","50250","0.4253","38.7","23629","39135","36604","340","126","Warren County, Pennsylvania","42","123"
"6234","2803","294","552","76502","23764","14608","14111","497","52738","41048","37225","3823","76502","70668","0.4414","39.2","83257","184959","174800","2332","1958","Butler County, Pennsylvania","42","019"
"306","184","5","54","14020","4657","2740","2528","212","9363","6728","6143","585","14020","53440","0.4030","39.5","17790","30003","28893","143","110","Elk County, Pennsylvania","42","047"
"12132","7973","2055","3177","201620","63667","41127","39602","1525","137953","111953","101496","10457","201620","66056","0.4324","38.6","210985","535078","448941","13664","9704","Lancaster County, Pennsylvania","42","071"
"3013","2112","329","119","46340","16741","9452","8980","472","29599","22508","20375","2133","46340","50696","0.4323","38.0","52262","107478","99737","996","405","Mercer County, Pennsylvania","42","085"
"450","291","14","2","6480","2582","1598","1495","103","3898","2988","2791","197","6480","45419","0.4288","39.0","12958","16565","15329","78","38","Potter County, Pennsylvania","42","105"
"1123","645","50","89","16310","5938","3754","3596","158","10372","8026","7204","822","16310","51324","0.4185","39.5","21810","40528","37026","357","161","Tioga County, Pennsylvania","42","117"
"1649","6621","1118","553","34777","12499","7521","7060","461","22278","16697","14658","2039","34777","79454","0.4805","39.0","42563","79313","71421","2993","1878","Newport County, Rhode Island","44","005"
"6158","18668","5257","10334","237971","67479","37207","34604","2603","170492","124033","109812","14221","237971","58974","0.4726","37.7","266330","626296","490918","60030","41437","Providence County, Rhode Island","44","007"
"1610","1966","122","507","19217","6541","3980","3838","142","12676","9567","8688","879","19217","83092","0.4932","37.3","21053","48153","42716","3296","1085","Bristol County, Rhode Island","44","001"
"3081","5455","363","143","67598","21936","14036","13620","416","45662","34650","32006","2644","67598","51399","0.4550","39.3","76776","166487","144333","2307","2843","Aiken County, South Carolina","45","003"
"552","87","14","68","3365","1340","748","697","51","2025","1382","1314","68","3365","27185","0.5028","38.6","4512","7950","7153","3","82","Allendale County, South Carolina","45","005"
"1348","744","55","167","9176","3372","2230","2166","64","5804","4505","4305","200","9176","49127","0.4841","39.0","10943","24442","21695","260","304","Edgefield County, South Carolina","45","037"
"530","151","17","29","12653","4343","2452","2394","58","8310","5979","5648","331","12653","42442","0.4619","39.0","14755","32150","28480","154","88","Chester County, South Carolina","45","023"
"597","329","6","3","15075","5212","2941","2765","176","9863","7309","6800","509","15075","36324","0.4572","38.3","20112","36861","31986","175","459","Colleton County, South Carolina","45","029"
"344","346","290","99","11600","4362","2675","2466","209","7238","5281","5066","215","11600","32063","0.5265","39.3","14997","31207","27061","92","57","Marion County, South Carolina","45","067"
"12191","5954","944","221","113104","32130","20617","19894","723","80974","62655","56854","5801","113104","61173","0.4384","39.6","124406","287397","250634","5172","4302","Lexington County, South Carolina","45","063"
"2670","2539","178","185","31978","12014","7798","7557","241","19964","15188","14075","1113","31978","49134","0.4868","38.3","40370","76923","66451","1191","739","Oconee County, South Carolina","45","073"
"10278","11588","1217","410","76881","19832","14054","13481","573","57049","45191","41674","3517","76881","63309","0.4198","40.2","84098","209202","178643","4794","3118","Berkeley County, South Carolina","45","015"
"10130","15702","2027","2381","159195","43923","26953","25610","1343","115272","79565","66770","12795","159195","64022","0.5052","40.1","187953","393492","337416","7565","6391","Charleston County, South Carolina","45","019"
"1940","1984","118","187","25498","11855","7813","7573","240","13643","10229","9761","468","25498","48456","0.5044","37.9","35345","61382","54032","745","365","Georgetown County, South Carolina","45","043"
"677","547","49","13","9613","3490","1972","1911","61","6123","4677","4158","519","9613","33586","0.4782","40.1","12049","23915","20842","154","68","Marlboro County, South Carolina","45","069"
"7316","4594","338","66","76798","24455","15328","14627","701","52343","40479","37604","2875","76798","50865","0.4570","38.7","88209","196603","173413","2390","1554","Anderson County, South Carolina","45","007"
"1097","706","34","118","17900","5897","3680","3601","79","12003","9417","8798","619","17900","41505","0.4377","40.2","21675","45568","39527","459","471","Chesterfield County, South Carolina","45","025"
"2248","992","51","157","27612","8889","5324","5067","257","18723","14197","13068","1129","27612","42336","0.4785","37.9","31453","69282","59422","1002","661","Greenwood County, South Carolina","45","047"
"4574","15363","825","402","131143","51571","34489","32405","2084","79572","59869","52335","7534","131143","50704","0.4442","38.1","205922","330496","272706","7216","4863","Horry County, South Carolina","45","051"
"1413","1084","281","36","24980","7992","5041","4869","172","16988","13037","12184","853","24980","51479","0.4416","39.6","29121","64650","56956","526","359","Kershaw County, South Carolina","45","055"
"1553","1080","253","62","33060","11804","6860","6660","200","21256","14190","13397","793","33060","37955","0.4836","38.5","42797","86945","76243","557","398","Orangeburg County, South Carolina","45","075"
"10252","6861","705","502","116645","35041","22046","21434","612","81604","62642","57693","4949","116645","52332","0.4573","39.0","129604","303389","259315","7911","5892","Spartanburg County, South Carolina","45","083"
"686","470","32","175","5334","2128","1309","1295","14","3206","2226","2060","166","5334","31422","0.4499","37.0","7707","14184","12063","171","37","Bamberg County, South Carolina","45","009"
"2610","12126","861","411","71477","30995","22297","21277","1020","40482","30619","28131","2488","71477","68377","0.4765","40.3","99204","178856","150523","5232","3910","Beaufort County, South Carolina","45","013"
"408","166","0","3","6179","2375","1392","1388","4","3804","2683","2522","161","6179","46339","0.4741","40.0","7464","14542","13013","65","113","Calhoun County, South Carolina","45","017"
"554","354","10","0","11029","3466","2084","2007","77","7563","5518","5009","509","11029","30812","0.4974","37.6","13767","30392","25659","29","310","Dillon County, South Carolina","45","033"
"582","235","62","35","7094","2494","1680","1656","24","4600","3576","3476","100","7094","45714","0.4444","39.8","9424","20046","16687","263","432","Saluda County, South Carolina","45","081"
"19816","26876","3321","2369","151853","36435","22223","21463","760","115418","80205","70042","10163","151853","54767","0.4817","38.3","173043","387819","335978","9528","7413","Richland County, South Carolina","45","079"
"417","138","16","146","9191","3304","2299","2282","17","5887","3849","3639","210","9191","38213","0.4931","37.6","11890","22286","19793","86","69","Fairfield County, South Carolina","45","039"
"431","245","56","53","6993","2435","1200","1146","54","4558","3124","3002","122","6993","33429","0.4132","39.3","9181","18212","16111","145","58","Hampton County, South Carolina","45","049"
"13543","16291","4885","929","192975","54588","34960","33576","1384","138387","103182","93927","9255","192975","60351","0.4671","38.9","211100","502708","420596","14217","13824","Greenville County, South Carolina","45","045"
"1797","4534","166","265","33899","12844","7862","7639","223","21055","16925","15936","989","33899","58849","0.4729","39.4","37426","90282","78668","1815","1991","Lancaster County, South Carolina","45","057"
"9019","4956","762","227","55351","14482","9507","9124","383","40869","31327","29253","2074","55351","63080","0.4280","39.2","60561","155427","134928","3283","2557","Dorchester County, South Carolina","45","035"
"3183","1728","49","176","52188","15805","10038","9759","279","36383","27121","24974","2147","52188","47058","0.4843","39.1","60746","136948","120229","1679","955","Florence County, South Carolina","45","041"
"3322","1404","282","43","25563","8044","5279","5138","141","17519","13379","12444","935","25563","43304","0.4600","38.2","31345","65629","56731","612","592","Laurens County, South Carolina","45","059"
"741","158","30","9","3957","2090","1472","1442","30","1867","1216","1071","145","3957","43633","0.4600","38.4","5634","8364","7657","143","39","McCormick County, South Carolina","45","065"
"8512","5100","563","614","47934","14292","9329","8971","358","33642","25915","21305","4610","47934","49573","0.4573","37.0","54264","123320","107641","1555","2194","Pickens County, South Carolina","45","077"
"1099","105","24","11","11432","3869","2269","2198","71","7563","5708","5503","205","11432","41186","0.4742","40.1","14095","27039","24054","115","36","Union County, South Carolina","45","087"
"700","330","105","223","12686","4889","2912","2822","90","7797","5469","5244","225","12686","32485","0.4805","39.2","15480","29799","26663","164","75","Williamsburg County, South Carolina","45","089"
"111","41","2","0","1182","354","215","212","3","828","609","538","71","1182","64083","0.4424","44.3","1348","2622","2319","9","90","Aurora County, South Dakota","46","003"
"123","280","6","4","3218","957","581","572","9","2261","1762","1546","216","3218","58158","0.4261","39.7","3604","7095","6401","9","192","Grant County, South Dakota","46","051"
"193","28","34","0","2356","809","499","494","5","1547","1206","1110","96","2356","57720","0.4208","43.0","3106","5336","4890","20","67","Tripp County, South Dakota","46","123"
"43","8","0","1","754","185","137","134","3","569","482","474","8","754","37400","0.4834","40.6","1009","2791","2020","4","0","Ziebach County, South Dakota","46","137"
"169","220","12","0","2624","881","519","497","22","1743","1294","1170","124","2624","54423","0.4761","43.0","3246","6358","5917","26","14","Spink County, South Dakota","46","115"
"661","245","1","0","2536","999","494","468","26","1537","1172","1022","150","2536","54737","0.4144","41.4","2969","5467","5159","5","4","Bon Homme County, South Dakota","46","009"
"2563","1739","344","37","12896","2814","1586","1536","50","10082","7065","5336","1729","12896","58136","0.4137","37.9","14563","34468","30565","354","1428","Brookings County, South Dakota","46","011"
"209","233","4","14","2986","1304","711","651","60","1682","1245","1176","69","2986","50588","0.4036","37.6","4232","6560","5939","93","59","Fall River County, South Dakota","46","047"
"439","120","18","0","2256","562","398","388","10","1694","1454","1292","162","2256","67105","0.3574","41.5","2885","5851","5310","45","85","Hamlin County, South Dakota","46","057"
"98","36","7","15","858","348","228","228","0","510","420","399","21","858","33295","0.5003","41.5","1278","3241","2346","7","10","Jackson County, South Dakota","46","071"
"338","302","87","29","3876","1664","1261","1202","59","2212","1820","1672","148","3876","58522","0.4400","41.6","5172","8484","7476","132","86","Custer County, South Dakota","46","033"
"38","8","0","1","597","218","131","129","2","379","273","258","15","597","57788","0.4125","44.5","720","1280","1216","8","0","Hyde County, South Dakota","46","069"
"115","5","10","0","895","311","152","145","7","584","414","402","12","895","55096","0.3875","46.0","1206","2250","2092","0","0","Faulk County, South Dakota","46","049"
"498","107","1","0","2903","1080","597","581","16","1823","1362","1313","49","2903","57089","0.4225","41.2","3403","7084","6660","8","43","Hutchinson County, South Dakota","46","067"
"235","354","9","27","2258","762","441","418","23","1496","1109","940","169","2258","55583","0.4605","40.1","3057","5353","4810","29","31","Walworth County, South Dakota","46","129"
"46","5","0","0","564","114","75","72","3","450","365","350","15","564","34808","0.4712","38.1","657","2026","1230","0","0","Buffalo County, South Dakota","46","017"
"222","106","4","8","2574","988","552","528","24","1586","1166","1089","77","2574","46679","0.4780","39.6","3793","5347","4764","11","16","Day County, South Dakota","46","037"
"63","35","49","4","1220","375","257","254","3","845","670","630","40","1220","58684","0.4451","41.9","1467","2831","2432","15","0","Douglas County, South Dakota","46","043"
"64","46","0","0","532","159","119","109","10","373","301","278","23","532","59655","0.3555","44.8","701","1287","1194","0","9","Harding County, South Dakota","46","063"
"51","59","4","4","1030","418","257","250","7","612","359","346","13","1030","44574","0.4798","40.7","1437","2196","2007","10","11","McPherson County, South Dakota","46","089"
"411","287","17","45","3873","1356","870","828","42","2517","1870","1746","124","3873","50348","0.4584","40.2","5048","10117","8012","17","20","Roberts County, South Dakota","46","109"
"24","13","0","0","569","236","126","118","8","333","266","259","7","569","62153","0.5137","43.8","814","1305","1238","0","0","Sully County, South Dakota","46","119"
"3879","2686","35","20","19749","4459","2842","2793","49","15290","12724","11761","963","19749","82473","0.4418","40.4","20532","56492","52503","610","763","Lincoln County, South Dakota","46","083"
"727","483","26","14","4700","1716","1042","1007","35","2984","2243","2064","179","4700","61846","0.4559","38.5","5785","12549","11438","99","128","Lake County, South Dakota","46","079"
"1256","1120","58","30","11048","3665","2203","2158","45","7383","5060","4044","1016","11048","52641","0.4556","38.1","14016","25202","22395","184","272","Lawrence County, South Dakota","46","081"
"1142","505","61","41","12075","3299","1697","1522","175","8776","6745","5929","816","12075","56376","0.4328","38.9","13116","27685","25597","176","164","Codington County, South Dakota","46","029"
"300","240","0","0","4164","1454","770","756","14","2710","2102","1798","304","4164","46508","0.4578","38.6","4839","10121","8570","48","32","Butte County, South Dakota","46","019"
"6","16","10","0","1195","332","237","230","7","863","684","649","35","1195","35759","0.5273","40.9","1541","4150","3154","6","5","Corson County, South Dakota","46","031"
"100","58","0","0","1544","463","292","285","7","1081","840","783","57","1544","71324","0.4311","42.9","2057","3809","3596","2","37","Edmunds County, South Dakota","46","045"
"44","47","0","0","673","249","162","157","5","424","294","274","20","673","54449","0.4125","45.1","988","1485","1456","6","0","Campbell County, South Dakota","46","021"
"121","24","10","3","984","261","166","166","0","723","589","562","27","984","47500","0.4366","40.6","1192","3387","2529","6","18","Bennett County, South Dakota","46","007"
"27","20","0","0","822","276","164","160","4","546","442","442","0","822","42250","0.4465","43.4","1102","1979","1753","8","0","Haakon County, South Dakota","46","055"
"8","42","0","0","408","148","79","79","0","260","171","159","12","408","46149","0.3847","44.9","576","793","668","0","6","Jones County, South Dakota","46","075"
"2033","1621","129","0","11027","2932","1802","1735","67","8095","6291","5845","446","11027","60578","0.4030","40.5","12065","26511","23412","300","155","Meade County, South Dakota","46","093"
"452","113","20","1","3498","1146","675","659","16","2352","1858","1693","165","3498","59242","0.4385","39.9","4031","8141","7568","26","69","Turner County, South Dakota","46","125"
"692","1259","254","16","16305","4573","2495","2385","110","11732","8426","7497","929","16305","58216","0.4455","40.2","18018","38354","33834","583","769","Brown County, South Dakota","46","013"
"130","75","0","0","1045","343","189","186","3","702","597","577","20","1045","64696","0.3598","40.4","1204","3393","3162","2","2","Hanson County, South Dakota","46","061"
"478","76","0","0","2228","609","396","396","0","1619","1276","1070","206","2228","61507","0.3919","41.3","2525","5397","4827","62","19","McCook County, South Dakota","46","087"
"40","0","0","11","661","202","135","135","0","459","360","347","13","661","30650","0.4975","39.5","809","2010","1317","4","0","Mellette County, South Dakota","46","095"
"233","75","45","3","2640","868","556","515","41","1772","1346","1250","96","2640","61538","0.4216","40.7","2900","6451","5713","89","40","Moody County, South Dakota","46","101"
"3912","4240","650","414","44074","13407","8154","7573","581","30667","22011","19791","2220","44074","57039","0.4550","38.9","48685","107918","94143","1104","974","Pennington County, South Dakota","46","103"
"678","846","209","14","6619","1901","1135","1041","94","4718","3627","3263","364","6619","70378","0.4697","40.1","7136","15206","13913","127","345","Union County, South Dakota","46","127"
"102","80","0","27","948","317","173","173","0","631","451","411","40","948","52910","0.4029","43.9","1343","2167","2017","11","14","Miner County, South Dakota","46","097"
"274","1886","86","55","9101","3506","2259","2105","154","5595","4295","3533","762","9101","53715","0.4332","38.4","10043","22196","20325","307","234","Asotin County, Washington","53","003"
"972","165","347","14","5973","1392","973","948","25","4581","3858","3623","235","5973","48294","0.4486","41.5","6608","19379","13693","1079","1410","Adams County, Washington","53","001"
"18","155","36","0","984","382","220","216","4","602","467","438","29","984","55900","0.3668","38.8","1243","2208","2043","3","35","Garfield County, Washington","53","023"
"3944","1440","166","399","24278","9363","6611","6029","582","14915","11090","9792","1298","24278","57634","0.4203","37.1","33503","62564","56007","875","1379","Mason County, Washington","53","045"
"5387","2438","708","491","48493","17510","11473","10805","668","30983","24821","21992","2829","48493","67028","0.4319","38.0","53893","124010","105712","4640","4666","Skagit County, Washington","53","057"
"1675","615","61","126","17554","7037","4904","4640","264","10517","8149","7301","848","17554","51775","0.4423","38.3","21746","44409","40038","766","482","Stevens County, Washington","53","065"
"16898","18280","2132","6169","202811","57767","34068","32082","1986","145044","109690","95516","14174","202811","56904","0.4545","37.5","216871","496256","446634","14282","9199","Spokane County, Washington","53","063"
"431","157","57","8","4525","1852","1237","1172","65","2673","2164","2022","142","4525","54631","0.4023","39.5","6050","10458","9903","75","82","Lincoln County, Washington","53","043"
"3389","1161","350","363","28384","9821","6102","5705","397","18563","14157","12990","1167","28384","58795","0.4519","37.9","37693","75545","61735","3615","3025","Chelan County, Washington","53","007"
"1427","1504","95","201","14705","7781","5316","4755","561","6924","5118","4142","976","14705","55127","0.4689","37.0","18618","30486","27242","974","610","Jefferson County, Washington","53","031"
"8660","13416","881","11808","103913","32391","21318","19984","1334","71522","56521","49839","6682","103913","75411","0.4166","41.2","112709","249790","222981","10438","4600","Kitsap County, Washington","53","035"
"39742","82461","34588","162252","882028","202829","124243","116241","8002","679199","500876","413322","87554","882028","94974","0.4672","39.0","935471","2182505","1619046","227279","220932","King County, Washington","53","033"
"967","706","35","26","9279","4608","2969","2592","377","4671","3443","3128","315","9279","46733","0.4295","38.0","16213","21448","18942","567","658","Pacific County, Washington","53","049"
"601","586","0","11","5727","2395","1638","1525","113","3332","2559","2346","213","5727","50591","0.4320","38.9","8260","13266","12091","252","149","Pend Oreille County, Washington","53","051"
"478","717","62","187","8252","3827","2560","2334","226","4425","3166","2687","479","8252","63622","0.5007","36.3","14119","16735","14601","638","428","San Juan County, Washington","53","055"
"439","295","36","8","4816","1670","1282","1162","120","3146","2462","2236","226","4816","65181","0.4084","38.4","5865","11713","10828","190","231","Skamania County, Washington","53","059"
"6495","3039","1358","1240","17999","3530","1986","1801","185","14469","10148","6930","3218","17999","42745","0.5071","33.3","20841","48947","41769","1178","4049","Whitman County, Washington","53","075"
"4653","3962","1133","488","83048","23609","15668","14777","891","59439","48764","45347","3417","83048","51637","0.4439","39.1","88698","246985","186265","11873","16380","Yakima County, Washington","53","077"
"1603","3046","270","307","32958","15211","9391","8589","802","17747","13214","11722","1492","32958","52192","0.4362","37.1","37110","74196","65065","2271","1237","Clallam County, Washington","53","009"
"3720","3642","347","96","41952","14219","8709","8022","687","27733","21535","19448","2087","41952","54506","0.4429","38.2","44711","105810","97250","1850","1186","Cowlitz County, Washington","53","015"
"499","325","4","10","3060","1339","938","837","101","1721","1217","1110","107","3060","41939","0.4790","37.9","4526","7511","6868","47","54","Ferry County, Washington","53","019"
"3697","2106","103","106","30618","11405","7218","6756","462","19213","15034","13281","1753","30618","53484","0.4252","37.8","35148","77301","68916","1100","1622","Lewis County, Washington","53","041"
"2029","796","126","200","15263","5041","3512","3295","217","10222","8591","7896","695","15263","62951","0.4355","38.8","17002","41889","33747","1727","2444","Douglas County, Washington","53","017"
"3769","3886","368","951","34768","13731","9142","8534","608","21037","16969","15108","1861","34768","68604","0.4229","38.8","41902","76706","67466","3801","1716","Island County, Washington","53","029"
"31938","30769","5271","16165","323296","84052","52989","49855","3134","239244","187227","166751","20476","323296","72113","0.4233","38.9","347022","854265","732586","43937","26188","Pierce County, Washington","53","053"
"6004","1639","534","165","26723","5548","3611","3447","164","21175","18155","17003","1152","26723","63584","0.4057","39.6","28063","89836","64433","5114","7451","Franklin County, Washington","53","021"
"3686","2742","221","223","22646","7552","4684","4410","274","15094","11653","10268","1385","22646","57858","0.4510","36.5","24745","57227","48910","1998","2172","Walla Walla County, Washington","53","071"
"9154","6549","1165","2626","86523","26223","16836","15486","1350","60300","46398","36628","9770","86523","62984","0.4406","36.0","96690","219395","186291","10476","8925","Whatcom County, Washington","53","073"
"351","69","0","13","4607","1915","1035","980","55","2692","2059","1904","155","4607","42216","0.4102","38.6","6667","11505","10579","38","0","Grant County, West Virginia","54","023"
"348","446","17","25","9288","3825","2367","2215","152","5463","4281","3924","357","9288","47857","0.4099","38.9","14019","22809","20619","144","9","Hampshire County, West Virginia","54","027"
"597","1016","26","64","9805","3666","2291","2246","45","6139","4548","4031","517","9805","51496","0.3935","38.9","10794","22221","20872","137","144","Brooke County, West Virginia","54","009"
"900","225","0","0","2685","1214","893","848","45","1471","1132","1066","66","2685","45545","0.4353","41.8","3922","7759","7142","19","41","Doddridge County, West Virginia","54","017"
"216","305","60","16","5674","2129","1547","1466","81","3545","2808","2646","162","5674","47438","0.4382","40.6","8309","13748","12719","196","203","Hardy County, West Virginia","54","031"
"2034","1337","46","84","22926","7544","4571","4428","143","15382","11760","10589","1171","22926","50305","0.4398","38.8","26383","55960","52477","407","187","Marion County, West Virginia","54","049"
"209","483","10","4","10501","3473","1996","1942","54","7028","5244","5008","236","10501","32764","0.4816","40.5","12856","24207","23074","38","0","Mingo County, West Virginia","54","059"
"542","1354","58","152","12678","4971","2583","2512","71","7707","5631","5014","617","12678","45763","0.4278","38.3","14359","29125","26994","193","64","Hancock County, West Virginia","54","029"
"555","313","46","5","12308","4755","2781","2663","118","7553","5696","5358","338","12308","48557","0.4504","39.1","15784","30934","28620","198","34","Marshall County, West Virginia","54","051"
"456","451","0","82","10069","3860","2409","2309","100","6209","5006","4755","251","10069","40086","0.4452","39.2","13148","24938","23270","67","146","Nicholas County, West Virginia","54","067"
"242","78","4","0","3142","1286","806","768","38","1856","1398","1273","125","3142","49118","0.3991","38.9","5350","6803","6445","27","0","Tucker County, West Virginia","54","093"
"171","161","1","0","3207","1306","757","754","3","1901","1345","1292","53","3207","43087","0.4714","39.6","5020","8734","7948","6","64","Tyler County, West Virginia","54","095"
"594","109","11","0","5562","2115","1305","1181","124","3447","2724","2489","235","5562","37373","0.4588","40.0","7443","13925","13184","31","20","Roane County, West Virginia","54","087"
"680","311","3","0","6614","2389","1556","1430","126","4225","3291","2934","357","6614","48578","0.4233","39.7","7513","16448","15318","66","71","Taylor County, West Virginia","54","091"
"1367","1710","134","365","35488","12028","7133","6790","343","23460","17471","15823","1648","35488","47321","0.4709","38.7","40269","84384","78782","645","313","Wood County, West Virginia","54","107"
"369","325","42","10","2587","924","671","643","28","1663","1205","1028","177","2587","42636","0.4197","36.7","3556","6835","6090","6","82","Gilmer County, West Virginia","54","021"
"524","271","0","0","11034","3957","2390","2286","104","7077","5608","5326","282","11034","46078","0.4514","40.0","13090","26121","24727","99","79","Mason County, West Virginia","54","053"
"246","590","26","0","5718","2249","1302","1273","29","3469","2514","2372","142","5718","38540","0.4379","41.4","7641","13316","12089","21","1","Monroe County, West Virginia","54","063"
"488","114","0","0","2835","955","574","532","42","1880","1572","1525","47","2835","56838","0.4908","38.6","3404","6936","6576","5","0","Pleasants County, West Virginia","54","073"
"3558","2223","188","574","39064","11919","6638","6387","251","27145","17780","15082","2698","39064","40028","0.5097","37.8","46379","92831","84504","698","508","Cabell County, West Virginia","54","011"
"1186","2952","251","491","20891","6392","4270","3971","299","14499","11827","10804","1023","20891","80430","0.4108","38.6","23177","56144","50860","1532","881","Jefferson County, West Virginia","54","037"
"645","324","8","29","13816","4931","2963","2805","158","8885","7247","6818","429","13816","36168","0.4887","41.3","16853","32609","30203","28","29","Logan County, West Virginia","54","045"
"103","143","0","7","3174","1393","824","819","5","1781","1380","1281","99","3174","42312","0.4476","39.2","5223","6879","6503","13","4","Pendleton County, West Virginia","54","071"
"1890","1062","90","205","27098","9098","5512","5211","301","18000","13957","12540","1417","27098","53022","0.4467","40.2","31707","67242","62791","346","233","Harrison County, West Virginia","54","033"
"1118","1150","73","234","17193","6385","3411","3188","223","10808","7436","6674","762","17193","50584","0.5061","38.2","20930","41604","39172","458","179","Ohio County, West Virginia","54","069"
"422","175","0","16","2826","1059","702","648","54","1767","1432","1307","125","2826","38382","0.4585","40.3","4009","7272","6797","12","47","Calhoun County, West Virginia","54","013"
"191","609","8","24","7185","2913","1925","1686","239","4272","3583","3224","359","7185","51745","0.4035","38.1","9976","17567","16112","234","46","Morgan County, West Virginia","54","065"
"2671","1105","133","59","31203","11172","6910","6653","257","20031","15775","14482","1293","31203","43748","0.4642","39.5","36177","72971","67020","503","475","Raleigh County, West Virginia","54","081"
"1554","394","74","15","21613","6675","4565","4431","134","14938","11946","11323","623","21613","60097","0.4372","38.8","24189","56108","52205","546","122","Putnam County, West Virginia","54","079"
"497","225","6","6","6324","2219","1464","1363","101","4105","3040","2696","344","6324","38459","0.4770","38.0","7914","16466","15538","68","50","Barbour County, West Virginia","54","001"
"357","203","16","9","7607","2865","1947","1832","115","4742","3536","3384","152","7607","27682","0.4655","39.6","11220","17248","16180","29","4","McDowell County, West Virginia","54","047"
"1210","823","13","99","15124","5457","3273","3206","67","9667","7134","6753","381","15124","37988","0.4952","38.5","19355","40159","36800","128","127","Wayne County, West Virginia","54","099"
"824","263","61","20","11334","4043","2726","2672","54","7291","5368","5109","259","11334","47837","0.4552","39.6","13408","28730","26891","108","120","Jackson County, West Virginia","54","035"
"1195","1756","88","75","25216","9236","5442","5303","139","15980","12001","11043","958","25216","40784","0.4357","39.5","29997","59450","55176","408","101","Mercer County, West Virginia","54","055"
"850","359","75","8","9713","3393","2117","1965","152","6320","4700","4392","308","9713","40322","0.4771","38.1","11398","24289","22355","34","103","Upshur County, West Virginia","54","097"
"218","82","5","0","3781","1431","946","848","98","2350","1782","1698","84","3781","34927","0.4727","38.0","5450","8329","7839","2","0","Webster County, West Virginia","54","101"
"2134","5345","186","288","44221","11762","7724","7359","365","32459","25125","22786","2339","44221","62515","0.3998","39.2","48578","114881","104212","2191","1363","Berkeley County, West Virginia","54","003"
"823","521","80","54","17441","6346","4026","3909","117","11095","8188","7798","390","17441","41394","0.4365","39.5","21496","42485","39200","105","169","Fayette County, West Virginia","54","019"
"271","216","6","11","2898","1172","698","648","50","1726","1162","1012","150","2898","43798","0.4340","39.0","6062","5583","5181","40","29","Iron County, Wisconsin","55","051"
"1235","213","139","4","12791","3754","2222","2116","106","9037","7135","6608","527","12791","54012","0.4174","42.9","15172","34104","26337","231","385","Clark County, Wisconsin","55","019"
"1745","2780","203","250","34182","8216","5190","4953","237","25966","21132","19436","1696","34182","84756","0.4006","39.3","35862","88008","82798","1410","448","St. Croix County, Wisconsin","55","109"
"1430","377","27","15","16036","5179","3338","3161","177","10857","8493","7720","773","16036","60908","0.3939","39.6","24197","37389","35420","219","139","Oconto County, Wisconsin","55","083"
"1119","319","43","68","12625","4079","2437","2275","162","8546","6496","5842","654","12625","58541","0.3944","39.6","17142","27164","25940","104","99","Lincoln County, Wisconsin","55","069"
"2360","503","39","45","22305","6819","4031","3822","209","15486","11502","10144","1358","22305","58693","0.4242","39.9","25789","49858","46158","460","283","Waupaca County, Wisconsin","55","135"
"1407","716","105","70","18907","6500","3896","3713","183","12407","9499","8487","1012","18907","52703","0.4386","39.7","24113","44662","40624","572","548","Barron County, Wisconsin","55","005"
"745","332","14","148","7796","2957","1867","1795","72","4839","3747","3334","413","7796","47714","0.4966","38.1","16355","16123","14807","169","31","Sawyer County, Wisconsin","55","113"
"774","224","12","16","7979","2766","1675","1579","96","5213","3906","3537","369","7979","55075","0.4154","40.2","10710","18576","16366","209","216","Green Lake County, Wisconsin","55","047"
"760","233","31","8","6688","2435","1507","1399","108","4253","3044","2678","366","6688","47956","0.4159","39.3","11001","13237","12357","87","64","Price County, Wisconsin","55","099"
"661","177","13","22","6648","2581","1557","1447","110","4067","3098","2709","389","6648","52288","0.3957","39.9","9980","15174","13964","180","93","Marquette County, Wisconsin","55","077"
"1108","995","89","44","18473","6471","3823","3609","214","12002","8667","7645","1022","18473","50330","0.4243","39.2","30795","39895","37364","311","158","Marinette County, Wisconsin","55","075"
"18881","17257","4435","23314","382175","92662","48907","46044","2863","289513","196975","167569","29406","382175","50606","0.4766","38.0","418866","942070","807462","32801","33122","Milwaukee County, Wisconsin","55","079"
"294","70","0","0","2432","833","440","435","5","1599","1227","1158","69","2432","44083","0.4285","40.5","3206","5800","5109","39","6","Shelby County, Missouri","29","205"
"3051","593","0","52","13575","4200","2840","2688","152","9375","7743","7201","542","13575","50560","0.4182","38.9","14780","37753","32240","209","104","Webster County, Missouri","29","225"
"87","78","10","5","2562","948","478","440","38","1614","1094","988","106","2562","50236","0.4395","40.1","2956","5145","4627","19","12","Atchison County, Missouri","29","005"
"876","329","11","0","6547","2130","1288","1241","47","4417","3538","3376","162","6547","47625","0.4564","40.8","7837","15977","14318","132","47","Bates County, Missouri","29","013"
"939","489","19","13","7872","3918","2338","2146","192","3954","3142","2868","274","7872","40249","0.4669","38.8","14234","18902","16495","89","82","Benton County, Missouri","29","015"
"205","109","48","8","2333","801","459","421","38","1532","1221","1141","80","2333","39530","0.4341","40.8","3263","6085","5100","12","0","Carter County, Missouri","29","035"
"563","193","38","9","3068","1167","812","743","69","1901","1501","1370","131","3068","40399","0.4420","38.9","3947","7436","6334","70","21","Dade County, Missouri","29","057"
"6363","2533","249","1236","76974","22005","12941","12350","591","54969","43513","39594","3919","76974","61336","0.4366","38.6","82755","190867","174252","3978","2879","Racine County, Wisconsin","55","101"
"10449","2549","257","574","70594","19217","10632","10161","471","51377","37735","31608","6127","70594","58543","0.4463","38.2","75606","165571","152721","2860","2355","Winnebago County, Wisconsin","55","139"
"362","98","4","9","4008","1386","842","801","41","2622","1907","1744","163","4008","45536","0.4378","37.7","9185","8767","7875","36","31","Forest County, Wisconsin","55","041"
"1309","538","40","21","15047","4590","2692","2563","129","10457","8058","7310","748","15047","64502","0.4157","39.7","16024","36548","34438","369","384","Green County, Wisconsin","55","045"
"518","270","14","21","6376","2324","1428","1356","72","4052","2944","2639","305","6376","47532","0.4087","40.8","9189","13996","12681","78","45","Rusk County, Wisconsin","55","107"
"1552","346","60","42","17004","5731","3554","3409","145","11273","8614","7738","876","17004","56531","0.4187","40.1","20890","40340","37468","194","167","Shawano County, Wisconsin","55","115"
"1091","59","175","9","8612","3170","1794","1707","87","5442","4056","3721","335","8612","49491","0.4105","39.3","12565","18948","17517","103","140","Langlade County, Wisconsin","55","067"
"7156","2270","288","540","73648","18754","10776","10296","480","54894","42359","38129","4230","73648","65572","0.4105","38.7","77016","184353","170456","3350","2279","Outagamie County, Wisconsin","55","087"
"767","305","98","56","12071","4034","2413","2279","134","8037","6224","5783","441","12071","52459","0.4274","39.8","14096","30333","25952","189","96","Vernon County, Wisconsin","55","123"
"2824","806","170","31","24112","7186","4225","3959","266","16926","13183","11985","1198","24112","68005","0.4094","39.8","26751","55743","51843","680","474","Columbia County, Wisconsin","55","021"
"584","215","83","23","8341","2660","1660","1598","62","5681","4414","4115","299","8341","66192","0.3818","40.3","9430","20263","19182","102","227","Kewaunee County, Wisconsin","55","061"
"7962","4319","931","1067","105271","26405","14890","14135","755","78866","60140","53090","7050","105271","62340","0.4354","38.7","109645","258334","232278","5232","6725","Brown County, Wisconsin","55","009"
"5928","3218","221","336","40981","11093","6199","5824","375","29888","21907","17786","4121","40981","59476","0.4348","37.3","44089","102800","93002","2231","942","Eau Claire County, Wisconsin","55","035"
"1107","527","25","60","15421","6078","3712","3482","230","9343","6920","6124","796","15421","56852","0.4599","38.5","31058","34834","32680","321","112","Oneida County, Wisconsin","55","085"
"1091","1135","30","34","18450","5953","3756","3558","198","12497","9602","8745","857","18450","59994","0.4007","38.9","24655","42986","40079","276","160","Polk County, Wisconsin","55","095"
"610","376","21","25","7236","2826","1805","1716","89","4410","3256","2967","289","7236","50280","0.4360","38.6","13263","15516","14541","84","74","Washburn County, Wisconsin","55","129"
"15759","5804","977","1316","158808","50159","31188","29963","1225","108649","87534","80460","7074","158808","87277","0.4451","38.6","165664","397893","368276","11399","7488","Waukesha County, Wisconsin","55","133"
"4962","2469","167","241","40874","12285","7756","7485","271","28589","22345","19417","2928","40874","63776","0.4328","37.9","52379","102419","91665","2253","1780","Walworth County, Wisconsin","55","127"
"676","372","24","26","6654","2457","1518","1400","118","4197","3090","2797","293","6654","50595","0.4421","39.0","8978","15510","14462","97","44","Crawford County, Wisconsin","55","023"
"1279","333","50","53","10752","3678","2232","2068","164","7074","5353","4669","684","10752","53490","0.4449","39.5","15146","24967","22988","277","124","Juneau County, Wisconsin","55","057"
"2610","1078","178","47","26222","7813","4870","4664","206","18409","13915","12488","1427","26222","59943","0.4161","39.5","30414","63223","57892","735","763","Sauk County, Wisconsin","55","111"
"4697","1393","195","357","54302","15847","9986","9562","424","38455","30701","28395","2306","54302","77663","0.4068","39.2","56737","134160","126016","2219","853","Washington County, Wisconsin","55","131"
"3474","906","79","23","25601","7781","4702","4551","151","17820","14129","12659","1470","25601","59742","0.4153","39.9","28385","61393","57285","499","236","Chippewa County, Wisconsin","55","017"
"14512","17289","4902","15549","222929","50338","30312","28394","1918","172591","124405","97799","26606","222929","73893","0.4424","37.9","232924","532000","471068","18234","22166","Dane County, Wisconsin","55","025"
"666","2042","231","261","19011","5564","3291","3010","281","13447","9693","8460","1233","19011","53986","0.4204","37.8","23144","42715","39191","390","457","Douglas County, Wisconsin","55","031"
"961","279","71","15","8199","2695","1541","1409","132","5504","4081","3674","407","8199","53650","0.4125","40.4","9933","19404","17490","156","64","Jackson County, Wisconsin","55","053"
"926","201","22","45","9850","3022","1823","1748","75","6828","5289","4737","552","9850","64124","0.4274","40.6","10885","23460","22229","228","132","Iowa County, Wisconsin","55","049"
"4492","1630","277","286","35807","11718","7255","6932","323","24089","19637","18296","1341","35807","85215","0.4824","38.4","37445","88112","81721","2520","1427","Ozaukee County, Wisconsin","55","089"
"5115","918","480","188","28675","7820","4814","4508","306","20855","15816","12874","2942","28675","58853","0.4347","37.4","30911","70343","64930","904","1208","Portage County, Wisconsin","55","097"
"3256","3440","275","449","64739","18646","10786","10187","599","46093","35256","31248","4008","64739","57875","0.4128","38.6","69028","160864","146136","2821","2361","Rock County, Wisconsin","55","105"
"585","162","28","22","8614","2679","1633","1514","119","5935","4703","4348","355","8614","53020","0.4157","41.7","10720","20125","18392","79","83","Taylor County, Wisconsin","55","119"
"960","510","75","7","9062","4109","2616","2441","175","4953","3652","3183","469","9062","46369","0.4238","38.0","17726","19000","17560","286","105","Adams County, Wisconsin","55","001"
"334","276","21","159","7057","2859","1744","1662","82","4198","3266","2936","330","7057","56096","0.4200","38.3","13335","14885","13714","137","72","Bayfield County, Wisconsin","55","007"
"1665","937","159","38","17915","5235","3094","2895","199","12680","9471","8633","838","17915","59587","0.4068","40.0","19914","44922","40018","503","344","Monroe County, Wisconsin","55","081"
"2455","795","120","54","32332","10552","5996","5708","288","21780","15955","14158","1797","32332","54913","0.4310","39.8","35068","72541","67964","756","702","Wood County, Wisconsin","55","141"
"517","270","20","157","6565","2225","1193","1111","82","4340","3281","2749","532","6565","42510","0.4410","35.7","9655","15407","14385","92","64","Ashland County, Wisconsin","55","003"
"62","186","17","4","1948","706","473","453","20","1242","905","834","71","1948","52181","0.4795","37.7","4825","4259","3990","15","18","Florence County, Wisconsin","55","037"
"4940","1158","188","70","32965","9735","5983","5624","359","23230","18727","16974","1753","32965","66291","0.4044","39.1","35818","84225","78170","984","1079","Jefferson County, Wisconsin","55","055"
"1060","2317","117","579","17574","2996","1932","1859","73","14578","11629","10522","1107","17574","82659","0.3877","42.6","20264","46921","41518","485","173","Campbell County, Wyoming","56","005"
"361","1105","103","75","6908","2139","1431","1265","166","4769","3587","3430","157","6908","66964","0.3876","38.9","9421","19163","16172","109","262","Lincoln County, Wyoming","56","023"
"1518","2427","233","232","32799","8393","4549","4337","212","24406","18390","16192","2198","32799","62772","0.4362","40.8","36979","79211","67517","604","544","Natrona County, Wyoming","56","025"
"557","430","0","284","5378","1558","900","882","18","3820","3170","2887","283","5378","69647","0.3970","42.3","6678","13876","12518","29","119","Converse County, Wyoming","56","009"
"119","34","0","0","964","416","216","210","6","548","406","391","15","964","39150","0.4727","40.9","1328","2139","1830","0","0","Niobrara County, Wyoming","56","027"
"853","2008","96","612","15523","3546","2115","2037","78","11977","9423","8757","666","15523","74843","0.4065","39.6","19771","43246","36942","677","760","Sweetwater County, Wyoming","56","037"
"1061","581","117","3","15727","5044","2987","2920","67","10683","7816","7247","569","15727","41125","0.4724","39.9","17975","40169","33753","564","730","Warren County, Tennessee","47","177"
"6029","3850","917","331","53859","15953","10061","9607","454","37906","26893","23423","3470","53859","48334","0.4877","37.8","60423","125931","111017","1545","2201","Washington County, Tennessee","47","179"
"2122","702","139","29","13640","4218","2420","2312","108","9422","7287","6365","922","13640","39937","0.4649","38.0","15615","33062","29409","217","178","Weakley County, Tennessee","47","183"
"529","114","57","28","6762","2962","1589","1517","72","3800","2621","2315","306","6762","37512","0.4662","39.5","9115","15988","14359","174","24","Benton County, Tennessee","47","005"
"698","210","66","27","4894","1730","1237","1105","132","3164","2529","2368","161","4894","44122","0.4754","39.9","5763","13636","11881","50","38","Bledsoe County, Tennessee","47","007"
"1246","825","40","0","16192","5872","3672","3551","121","10320","8143","7576","567","16192","39803","0.4894","39.9","20970","39155","34469","141","68","Campbell County, Tennessee","47","013"
"875","143","5","0","5488","1781","1287","1239","48","3707","2854","2664","190","5488","55330","0.4285","39.8","6132","13997","12488","68","73","Cannon County, Tennessee","47","015"
"475","131","0","22","2878","1065","633","614","19","1813","1200","1136","64","2878","42711","0.4846","39.1","4224","7955","7163","24","9","Houston County, Tennessee","47","083"
"3758","2894","159","87","34688","10089","6664","6361","303","24599","19677","18265","1412","34688","57170","0.4351","39.7","37677","90866","81110","1100","760","Maury County, Tennessee","47","119"
"3729","457","425","90","18033","6381","4300","4132","168","11652","8900","8454","446","18033","49279","0.4583","41.8","25670","45390","35844","576","694","Polk County, Texas","48","373"
"317","11","1","0","2547","1036","703","655","48","1511","1109","1086","23","2547","50076","0.4406","40.7","3732","6981","5774","75","23","Refugio County, Texas","48","391"
"3432","550","21","11","20156","7543","5308","4985","323","12613","10375","9714","661","20156","54654","0.4542","41.6","23421","54486","43178","728","728","Van Zandt County, Texas","48","467"
"4016","570","108","0","13460","3892","2545","2373","172","9568","7696","7246","450","13460","54152","0.4667","40.1","14889","40074","28677","805","1211","Caldwell County, Texas","48","055"
"687","218","16","3","5180","1752","922","907","15","3428","2554","2345","209","5180","45302","0.4349","39.9","6240","12633","10383","172","216","Wilbarger County, Texas","48","487"
"189","64","0","0","1694","438","298","291","7","1256","967","954","13","1694","66610","0.4371","42.4","1977","5593","4818","75","89","Martin County, Texas","48","317"
"284","201","24","0","5106","1704","999","974","25","3402","2609","2463","146","5106","45930","0.4238","40.0","6394","11976","10615","58","38","Linn County, Missouri","29","115"
"1026","525","102","64","15878","5422","3329","3141","188","10456","8050","7527","523","15878","38357","0.4617","38.6","18281","39706","33897","152","186","Howell County, Missouri","29","091"
"4437","2664","510","41","19864","4498","2954","2870","84","15366","12414","10171","2243","19864","55273","0.3975","38.0","22280","49542","43829","568","601","Johnson County, Missouri","29","101"
"1089","291","64","0","14112","4398","2852","2743","109","9714","8054","7533","521","14112","47257","0.4158","40.8","16022","35119","30999","238","92","Laclede County, Missouri","29","105"
"657","105","52","6","3762","1247","826","792","34","2515","1859","1658","201","3762","47569","0.4424","38.2","4606","8700","7567","44","0","Maries County, Missouri","29","125"
"3181","1288","344","61","17981","4986","2852","2738","114","12995","9834","8325","1509","17981","44154","0.4848","36.6","20287","43883","38230","614","1578","Phelps County, Missouri","29","161"
"6179","4386","621","234","39305","9879","6505","6035","470","29426","22213","19950","2263","39305","80393","0.4261","40.0","41776","99737","89026","2801","2111","Platte County, Missouri","29","165"
"3543","879","131","0","24898","7258","4330","4196","134","17640","13603","12255","1348","24898","46466","0.4185","38.7","30065","59966","54145","272","168","St. Francois County, Missouri","29","187"
"14057","11417","2371","13466","141952","31702","15035","13644","1391","110250","62583","50680","11903","141952","43896","0.5048","38.7","176729","303603","253186","8363","9230","St. Louis city, Missouri","29","510"
"738","234","6","0","6763","2407","1562","1533","29","4356","3444","3210","234","6763","58772","0.4115","40.3","7338","17306","16097","165","49","Andrew County, Missouri","29","003"
"1258","1112","3","239","16390","5585","3258","3151","107","10805","8621","7846","775","16390","39915","0.4710","39.3","19858","41998","36559","254","192","Butler County, Missouri","29","023"
"212","268","9","1","3503","1293","787","752","35","2210","1769","1692","77","3503","50830","0.4344","40.7","4654","8692","7605","73","11","Carroll County, Missouri","29","033"
"429","104","14","0","3035","1166","750","726","24","1869","1527","1411","116","3035","51679","0.4299","39.9","4194","8099","6692","18","36","Daviess County, Missouri","29","061"
"143","81","0","4","2022","807","416","402","14","1215","946","848","98","2022","49524","0.4105","40.2","2792","4320","3938","8","8","Holt County, Missouri","29","087"
"1317","550","37","11","11565","3435","1965","1895","70","8130","6142","5534","608","11565","48784","0.4421","38.3","13036","27924","25409","126","110","Marion County, Missouri","29","127"
"504","81","11","19","5120","1549","1025","1024","1","3571","2947","2709","238","5120","61687","0.4030","39.7","6629","13481","12838","4","4","Osage County, Missouri","29","151"
"451","184","14","0","5059","1988","1183","1105","78","3071","2488","2274","214","5059","34971","0.4357","38.2","6638","13515","11479","80","0","Ripley County, Missouri","29","181"
"2605","277","66","30","12654","4016","2934","2703","231","8638","7093","6693","400","12654","60125","0.4235","39.4","15502","34267","31343","344","103","Warren County, Missouri","29","219"
"1266","215","9","29","9231","2934","1734","1674","60","6297","5245","4919","326","9231","41483","0.4533","38.4","11070","23758","20742","25","48","Washington County, Missouri","29","221"
"4522","1853","107","7","31645","8931","5778","5621","157","22714","18679","17176","1503","31645","60645","0.4107","39.1","34213","85212","76819","677","658","Christian County, Missouri","29","043"
"1210","304","63","1","3807","1263","695","646","49","2544","1937","1773","164","3807","55918","0.3919","41.2","4325","9190","8441","37","30","DeKalb County, Missouri","29","063"
"221","225","3","5","3429","1254","691","637","54","2175","1718","1601","117","3429","42917","0.4010","39.2","4385","8306","7193","59","25","Harrison County, Missouri","29","081"
"1546","696","102","1","13050","4188","2454","2392","62","8862","7301","6548","753","13050","58766","0.4204","39.9","14807","32102","29007","233","121","Lafayette County, Missouri","29","107"
"1879","972","236","26","9258","2465","1250","1229","21","6793","4898","3775","1123","9258","41929","0.5137","35.9","11542","25075","22232","160","708","Adair County, Missouri","29","001"
"91","260","8","0","1768","616","382","364","18","1152","845","823","22","1768","50085","0.5092","42.2","2369","4813","3185","16","0","Scotland County, Missouri","29","199"
"93","76","5","0","2128","703","384","384","0","1425","1022","950","72","2128","46481","0.4222","40.0","3337","6048","4880","226","211","Sullivan County, Missouri","29","211"
"95","170","53","1","2657","910","511","501","10","1747","1347","1249","98","2657","48909","0.4638","41.6","3497","6674","5664","33","39","Clark County, Missouri","29","045"
"2912","3804","256","189","45759","12950","7418","7057","361","32809","25564","23097","2467","45759","48357","0.4367","38.5","51322","119041","100363","1406","1627","Jasper County, Missouri","29","097"
"431","406","16","13","3752","1302","685","679","6","2450","1963","1824","139","3752","45988","0.4290","39.0","4550","9763","8745","22","42","Lewis County, Missouri","29","111"
"671","731","44","5","8259","2287","1637","1596","41","5972","5051","4668","383","8259","41643","0.4233","41.5","9983","22611","17327","253","793","McDonald County, Missouri","29","119"
"761","428","48","20","7576","2248","1407","1367","40","5328","4342","3960","382","7576","55863","0.3927","40.2","8748","18857","17401","144","116","Perry County, Missouri","29","157"
"1742","939","101","11","11712","3638","2300","2197","103","8074","6867","5990","877","11712","45660","0.4360","37.3","13573","31294","26862","180","79","Polk County, Missouri","29","167"
"879","394","125","57","8868","2746","1784","1681","103","6122","4963","4591","372","8868","61957","0.4005","40.4","10078","22621","20124","105","67","Ray County, Missouri","29","177"
"614","341","54","34","6369","1750","1031","962","69","4619","3382","3038","344","6369","49321","0.4258","38.2","7348","16311","15052","94","81","Hill County, Montana","30","041"
"292","251","72","22","2274","807","497","491","6","1467","1118","1062","56","2274","42298","0.4388","38.7","2922","5688","4980","43","43","Chouteau County, Montana","30","015"
"536","864","89","48","8122","3561","2255","2121","134","4561","3250","2991","259","8122","40140","0.4744","36.4","11591","19361","16693","393","198","Lincoln County, Montana","30","053"
"352","525","46","90","7782","2643","1551","1445","106","5139","3602","3040","562","7782","53068","0.4729","39.2","9599","16255","14224","209","151","Park County, Montana","30","067"
"44","15","0","0","351","133","82","82","0","218","145","137","8","351","43047","0.4722","40.4","469","668","614","21","0","Treasure County, Montana","30","103"
"113","172","11","30","2366","780","457","452","5","1586","1175","1106","69","2366","41279","0.4374","39.7","2841","6615","5570","45","3","Blaine County, Montana","30","005"
"243","96","27","92","1566","733","507","493","14","833","530","518","12","1566","49886","0.4162","40.1","2209","3648","3403","11","21","Sweet Grass County, Montana","30","097"
"343","159","9","16","2464","996","530","521","9","1468","1153","1110","43","2464","55000","0.4167","39.3","2919","5987","5298","40","16","Teton County, Montana","30","099"
"11","3","0","0","518","231","125","117","8","287","247","229","18","518","43625","0.4703","42.6","690","1234","1131","30","24","Prairie County, Montana","30","079"
"490","299","61","0","4163","1267","662","662","0","2896","2082","1898","184","4163","36045","0.4796","38.6","5397","13627","8363","40","80","Glacier County, Montana","30","035"
"17","114","2","2","1334","342","183","183","0","992","673","588","85","1334","64545","0.4112","44.5","1534","2834","2462","0","71","Fallon County, Montana","30","025"
"39","25","0","0","351","136","89","86","3","215","136","131","5","351","43875","0.5104","41.2","478","728","642","12","0","Golden Valley County, Montana","30","037"
"1718","905","235","148","14960","4862","2464","2357","107","10098","6559","5633","926","14960","45718","0.4710","37.5","17242","34149","31467","361","527","Silver Bow County, Montana","30","093"
"470","136","15","98","3761","1318","930","918","12","2443","1829","1698","131","3761","64645","0.3850","38.9","4866","9417","8747","24","49","Stillwater County, Montana","30","095"
"814","441","0","35","4484","1554","1140","1079","61","2930","2298","2176","122","4484","69646","0.3998","38.2","5112","11728","10900","63","53","Jefferson County, Montana","30","043"
"150","139","2","2","1308","583","374","314","60","725","445","404","41","1308","49881","0.4972","37.3","2832","3276","3034","9","7","Granite County, Montana","30","039"
"38","13","1","20","792","318","165","155","10","474","359","334","25","792","39655","0.4406","45.7","1173","2111","1813","12","5","Wheatland County, Montana","30","107"
"390","285","192","67","3570","1687","944","897","47","1883","1367","1202","165","3570","54107","0.4333","38.7","7002","8245","7195","49","230","Madison County, Montana","30","057"
"90","106","8","17","1639","532","354","336","18","1107","715","567","148","1639","55521","0.4567","41.4","2161","3441","3060","28","44","Sheridan County, Montana","30","091"
"24","59","0","0","628","222","149","148","1","406","275","254","21","628","48000","0.4491","44.7","784","1307","1040","0","0","Carter County, Montana","30","011"
"322","137","0","30","3609","1063","754","741","13","2546","2145","1988","157","3609","49859","0.4293","39.5","4732","13266","8881","29","74","Big Horn County, Montana","30","003"
"1597","1146","6","58","11802","4420","3063","2859","204","7382","5718","5150","568","11802","48829","0.4535","37.9","16886","29820","25087","241","248","Lake County, Montana","30","047"
"2299","2576","184","130","27893","8141","4991","4626","365","19752","14355","12593","1762","27893","65791","0.4210","37.7","31621","67138","62524","429","339","Lewis and Clark County, Montana","30","049"
"238","217","16","0","2103","844","490","481","9","1259","981","933","48","2103","51151","0.4346","39.7","2692","5927","5344","41","36","Pondera County, Montana","30","073"
"3617","4759","432","414","66385","18631","10835","10257","578","47754","35746","31090","4656","66385","61264","0.4540","39.0","71184","156854","142621","1877","1096","Yellowstone County, Montana","30","111"
"4751","5643","589","1302","49313","12770","7718","7305","413","36543","26303","20512","5791","49313","54062","0.4729","36.9","53955","116660","105577","1682","1540","Missoula County, Montana","30","063"
"266","0","0","0","2617","712","514","460","54","1905","1556","1525","31","2617","70005","0.3768","45.8","3037","8631","5310","303","612","Yoakum County, Texas","48","501"
"2381","381","123","57","10933","3025","1876","1812","64","7908","6229","6065","164","10933","48384","0.4301","40.5","13401","32100","23732","777","1081","Hale County, Texas","48","189"
"667","146","8","0","9293","3027","1866","1860","6","6266","5007","4896","111","9293","42522","0.4653","40.9","12290","25178","18875","380","454","Shelby County, Texas","48","419"
"403","114","0","0","4963","1941","1125","1113","12","3022","2247","2171","76","4963","39142","0.4449","39.4","6951","11974","10034","114","106","Red River County, Texas","48","387"
"324","34","8","12","3896","1510","915","881","34","2386","1937","1810","127","3896","44940","0.4417","41.5","5249","10065","8461","126","112","Runnels County, Texas","48","399"
"204","72","32","0","1412","486","291","291","0","926","722","705","17","1412","54306","0.4044","44.0","2026","3808","2822","140","168","Sutton County, Texas","48","435"
"5325","4073","403","118","43314","12082","7610","7196","414","31232","22827","20473","2354","43314","53903","0.4684","41.1","48598","113076","92271","2910","2437","Tom Green County, Texas","48","451"
"3222","884","419","439","32255","9977","6578","6155","423","22278","17549","16257","1292","32255","56834","0.4680","40.4","37149","91105","72116","2037","1630","Victoria County, Texas","48","469"
"1502","64","125","20","15199","5059","3050","2914","136","10140","7937","7641","296","15199","48310","0.4759","41.8","17633","41228","31482","700","1315","Wharton County, Texas","48","481"
"5692","6421","1001","349","48356","13610","7643","7351","292","34746","25713","23113","2600","48356","48650","0.4581","39.0","56057","117060","94904","2766","2910","Wichita County, Texas","48","485"
"19","3","0","0","227","102","75","70","5","125","96","96","0","227","72188","0.3924","41.5","405","613","560","19","0","Borden County, Texas","48","033"
"496","169","39","11","4715","1951","1087","1066","21","2764","1956","1846","110","4715","37662","0.5129","39.9","6413","9886","8590","55","96","Marion County, Texas","48","315"
"1301","245","883","42","16286","4675","3469","3346","123","11611","10525","10100","425","16286","39625","0.4493","39.8","18387","57962","28358","5302","6275","Maverick County, Texas","48","323"
"6929","2390","517","196","48454","15777","9859","9422","437","32677","24771","23193","1578","48454","54815","0.4467","40.0","55971","129692","103059","1797","2213","Grayson County, Texas","48","181"
"1073","105","67","0","3752","1473","938","908","30","2279","1690","1539","151","3752","53848","0.4507","40.6","6264","10723","8679","67","62","Live Oak County, Texas","48","297"
"1754","426","89","39","10255","3687","2387","2276","111","6568","5202","4620","582","10255","50154","0.4554","40.4","15504","28298","21671","655","455","Palo Pinto County, Texas","48","363"
"729","146","873","9","4282","1446","815","785","30","2836","2131","2030","101","4282","56127","0.5306","41.6","5995","12633","10476","188","153","Karnes County, Texas","48","255"
"1268","76","13","8","7048","2631","1621","1568","53","4417","3700","3427","273","7048","55357","0.5146","43.0","9252","18413","15596","100","94","DeWitt County, Texas","48","123"
"636","236","0","0","5367","2078","1218","1186","32","3289","2328","2222","106","5367","48651","0.4479","41.2","6720","13769","11145","45","112","Callahan County, Texas","48","059"
"547","234","3","0","11934","4810","2900","2790","110","7124","5645","5466","179","11934","44848","0.4331","39.7","14623","29683","25394","74","135","Cass County, Texas","48","067"
"7705","1560","223","44","45460","12788","8023","7756","267","32672","24501","21871","2630","45460","50180","0.4685","39.6","52069","121085","93179","2289","3259","Gregg County, Texas","48","183"
"1065","94","21","0","4269","1538","887","871","16","2731","2052","1945","107","4269","52664","0.4491","42.4","5290","11105","8413","231","747","Madison County, Texas","48","313"
"21789","6670","1667","1199","113488","26313","16254","15485","769","87175","65395","54507","10888","113488","52429","0.4791","38.5","127070","300582","248249","5539","7783","Lubbock County, Texas","48","303"
"10654","2294","213","92","38015","9735","6841","6543","298","28280","24279","23244","1035","38015","70107","0.4092","40.3","41433","122679","99793","3054","3002","Kaufman County, Texas","48","257"
"3251","919","90","81","14253","4988","3593","3546","47","9265","7804","7484","320","14253","84747","0.4890","39.7","16089","43339","37101","955","1068","Kendall County, Texas","48","259"
"168","23","0","34","2271","750","446","440","6","1521","1201","1155","46","2271","50580","0.4073","42.0","2972","5766","4228","60","240","Floyd County, Texas","48","153"
"184","135","0","0","2054","622","353","353","0","1432","1166","1086","80","2054","52273","0.4025","38.9","2515","6887","4877","234","318","Bailey County, Texas","48","017"
"1943","797","24","36","14069","3273","2090","2046","44","10796","9456","9261","195","14069","91141","0.4240","41.6","15771","41023","34812","839","723","Chambers County, Texas","48","071"
"15368","19639","4672","731","122689","25547","17014","16476","538","97142","73919","68498","5421","122689","54884","0.4372","41.0","139978","327097","267378","11623","8439","Bell County, Texas","48","027"
"4825","1973","2206","1126","124605","38630","27049","26390","659","85975","73777","71358","2419","124605","38758","0.4833","38.2","151096","419669","250112","24936","25457","Cameron County, Texas","48","061"
"421","258","16","83","6145","1486","877","867","10","4659","3858","3655","203","6145","49701","0.3949","42.9","7069","18532","12814","627","1448","Deaf Smith County, Texas","48","117"
"10657","23946","8816","4982","268310","70389","48308","46712","1596","197921","155968","148631","7337","268310","46871","0.4613","39.1","296101","811690","509357","77879","59607","El Paso County, Texas","48","141"
"431","88","230","0","2269","882","440","421","19","1387","1254","1208","46","2269","50151","0.5508","39.6","3056","6460","5112","62","69","La Salle County, Texas","48","283"
"19","0","0","0","418","237","128","122","6","181","134","131","3","418","43208","0.4328","38.7","785","896","803","0","8","Terrell County, Texas","48","443"
"2207","329","17","0","7100","3027","1902","1834","68","4073","3083","2940","143","7100","44497","0.4263","40.0","10868","18863","15440","119","125","Tyler County, Texas","48","457"
"253","41","0","0","2183","707","432","421","11","1476","1178","1097","81","2183","49315","0.4379","43.5","2721","5272","4033","52","181","Wheeler County, Texas","48","483"
"496","20","20","14","3452","1243","778","758","20","2209","1745","1644","101","3452","63835","0.4654","40.5","4158","8655","7404","21","111","Archer County, Texas","48","009"
"764","256","18","0","4088","1494","954","900","54","2594","1619","1333","286","4088","47080","0.4443","42.3","5532","9145","7226","198","260","Brewster County, Texas","48","043"
"11751","5857","4757","1137","238345","62834","46138","44858","1280","175511","153502","148176","5326","238345","40014","0.4867","39.1","276307","846855","481916","47893","60163","Hidalgo County, Texas","48","215"
"10144","3540","965","360","77678","24593","16011","15536","475","53085","41754","38383","3371","77678","56810","0.4667","40.0","90418","225116","178455","5277","4641","Smith County, Texas","48","423"
"38","3","0","0","1354","312","184","184","0","1042","764","764","0","1354","47386","0.4284","46.0","1819","3418","2599","82","20","Crockett County, Texas","48","105"
"745","96","102","0","2146","835","503","489","14","1311","965","934","31","2146","40313","0.4223","41.5","3469","5271","4052","26","94","Haskell County, Texas","48","207"
"2169","1077","493","25","11064","3143","1619","1512","107","7921","6071","5679","392","11064","54208","0.4696","40.6","13180","31769","25520","490","360","Howard County, Texas","48","227"
"176","48","6","0","1790","898","503","486","17","892","683","674","9","1790","49306","0.4953","38.0","2882","4715","3715","60","100","Mills County, Texas","48","333"
"1041","263","21","67","7800","2949","1806","1741","65","4851","3762","3438","324","7800","51765","0.4554","41.8","10269","19189","15231","154","212","Montague County, Texas","48","337"
"1223","181","6","2","8637","3054","2026","1979","47","5583","4488","4253","235","8637","52982","0.4493","42.5","11280","23097","18821","90","232","Panola County, Texas","48","365"
"451","431","0","0","4311","2141","1293","1267","26","2170","1736","1673","63","4311","34992","0.4969","39.1","8306","10382","8969","92","22","Sabine County, Texas","48","403"
"50","20","0","0","1019","279","168","161","7","740","620","593","27","1019","51926","0.5065","45.6","1416","3030","2135","120","150","Sherman County, Texas","48","421"
"749","86","40","27","2505","964","595","588","7","1541","1217","1129","88","2505","39771","0.4793","42.5","3196","6783","5130","71","215","Swisher County, Texas","48","437"
"5982","1131","571","70","33189","10092","6667","6395","272","23097","17858","16366","1492","33189","54959","0.4402","39.5","37798","93354","74382","1820","1959","Hunt County, Texas","48","231"
"980","159","21","19","4605","1656","1082","1047","35","2949","2462","2267","195","4605","48207","0.4345","41.2","5795","12831","9842","211","603","Camp County, Texas","48","063"
"125","176","0","9","1838","500","351","347","4","1338","1013","1013","0","1838","38000","0.4383","43.9","2349","5441","3182","222","779","Hansford County, Texas","48","195"
"7614","4933","580","104","54110","14719","10413","9870","543","39391","32988","31497","1491","54110","74496","0.3992","40.8","58406","156604","130470","4907","2976","Guadalupe County, Texas","48","187"
"572","217","24","0","4105","1531","996","939","57","2574","2040","1916","124","4105","55989","0.4279","41.1","5257","10313","8848","60","106","Clay County, Texas","48","077"
"753","7","4","0","1678","540","331","314","17","1138","922","894","28","1678","58298","0.3720","45.9","1939","4130","3199","118","164","Hartley County, Texas","48","205"
"82","6","129","0","1084","205","144","144","0","879","729","682","47","1084","74868","0.3476","44.9","1280","3731","2561","157","188","Reagan County, Texas","48","383"
"2215","487","167","4","12992","4896","3069","2940","129","8096","6581","6158","423","12992","53307","0.4401","40.2","16337","35029","27968","864","800","Hill County, Texas","48","217"
"1308","181","32","22","8377","2888","1849","1803","46","5489","4248","4049","199","8377","44418","0.4480","41.2","10731","22585","16999","469","829","Limestone County, Texas","48","293"
"5301","881","81","58","23757","6675","4010","3852","158","17082","13255","11294","1961","23757","44847","0.4943","37.9","28442","64576","50632","1412","1203","Nacogdoches County, Texas","48","347"
"432","218","24","23","3203","933","564","542","22","2270","1841","1770","71","3203","55359","0.4130","43.3","3805","9638","6338","547","835","Parmer County, Texas","48","369"
"6962","2598","789","155","44263","13312","9064","8813","251","30951","26162","25013","1149","44263","77503","0.4328","40.5","50045","132401","109531","2150","1492","Parker County, Texas","48","367"
"897","1960","46","18","17354","7202","5025","4826","199","10152","7655","7111","544","17354","53054","0.4580","37.2","19816","42324","36997","490","218","Ravalli County, Montana","30","081"
"234","90","0","8","3386","1118","667","646","21","2268","1743","1545","198","3386","53162","0.3997","40.5","4879","7375","6652","86","15","Valley County, Montana","30","105"
"2753","3199","410","296","34329","10681","5989","5764","225","23648","17676","15714","1962","34329","49913","0.4724","38.4","38857","78229","70559","1028","511","Cascade County, Montana","30","013"
"344","135","35","29","4912","1802","931","902","29","3110","2269","2069","200","4912","50540","0.4667","39.1","5896","11038","9947","6","75","Fergus County, Montana","30","027"
"3","22","0","2","438","167","100","98","2","271","220","206","14","438","42000","0.4716","42.8","814","1036","917","0","0","Garfield County, Montana","30","033"
"127","273","3","5","1786","770","471","471","0","1016","646","608","38","1786","41705","0.4474","38.1","2504","4161","3781","57","4","Mineral County, Montana","30","061"
"37","0","0","0","204","76","55","33","22","128","94","88","6","204","51250","0.4150","49.4","302","453","394","20","0","Petroleum County, Montana","30","069"
"663","121","0","2","2426","941","625","602","23","1485","1148","1049","99","2426","54667","0.4208","36.7","3203","5245","4883","9","19","Powell County, Montana","30","077"
"362","434","7","0","5036","2410","1485","1322","163","2626","1923","1720","203","5036","40823","0.4625","38.0","6762","11565","10042","105","93","Sanders County, Montana","30","089"
"5","67","0","0","498","182","98","98","0","316","254","251","3","498","53958","0.3241","43.5","601","1102","930","19","12","Wibaux County, Montana","30","109"
"3504","6879","450","283","43777","9208","6274","5933","341","34569","25694","19223","6471","43777","66397","0.4647","37.8","49478","107687","96177","1533","1596","Gallatin County, Montana","30","031"
"102","176","7","0","702","296","178","157","21","406","295","266","29","702","46607","0.3997","42.5","1368","1864","1569","18","34","Meagher County, Montana","30","059"
"306","163","21","39","4524","1678","1054","1011","43","2846","1913","1727","186","4524","58707","0.4031","38.9","6570","10475","9659","73","24","Carbon County, Montana","30","009"
"632","414","39","0","3992","1375","821","812","9","2617","1662","1474","188","3992","43201","0.4927","38.5","5344","9273","8330","59","130","Beaverhead County, Montana","30","001"
"2118","4021","241","300","38773","12805","8093","7674","419","25968","19198","17594","1604","38773","56182","0.4581","38.0","48785","99293","88494","1520","626","Flathead County, Montana","30","029"
"311","173","0","0","2181","853","509","492","17","1328","991","899","92","2181","43274","0.4173","38.6","2733","4735","4329","70","13","Musselshell County, Montana","30","065"
"112","55","0","10","1521","565","339","324","15","956","672","591","81","1521","49835","0.4145","41.3","2354","3366","3100","17","23","Harlan County, Nebraska","31","083"
"944","323","20","4","5656","1761","1164","1149","15","3895","2768","2528","240","5656","60298","0.4586","39.8","6327","13032","11972","77","64","York County, Nebraska","31","185"
"3246","1185","178","58","19062","4824","2673","2543","130","14238","10833","9225","1608","19062","59431","0.4503","38.8","20482","48640","42651","832","826","Buffalo County, Nebraska","31","019"
"330","118","211","6","3731","986","514","474","40","2745","2318","1937","381","3731","58872","0.3953","41.6","4205","10586","6637","907","1609","Colfax County, Nebraska","31","037"
"88","77","4","0","1243","500","277","266","11","743","503","462","41","1243","49962","0.4581","38.0","1746","2777","2482","2","2","Hitchcock County, Nebraska","31","087"
"1057","549","127","17","12947","3889","2172","2115","57","9058","6951","6422","529","12947","62305","0.4138","39.6","13784","32893","27497","1228","1169","Platte County, Nebraska","31","141"
"216","31","6","5","2052","743","458","441","17","1309","1058","1008","50","2052","67719","0.3680","40.7","2751","5143","4460","28","37","Polk County, Nebraska","31","143"
"290","166","0","4","4743","1431","642","626","16","3312","2472","2297","175","4743","54004","0.3899","41.3","5443","10803","9636","52","377","Box Butte County, Nebraska","31","013"
"101","120","57","0","1387","579","347","320","27","808","524","487","37","1387","43098","0.4843","40.6","1893","2972","2553","10","47","Brown County, Nebraska","31","017"
"160","251","5","17","2273","941","516","492","24","1332","965","880","85","2273","45371","0.4810","41.9","2904","5178","4497","29","11","Sheridan County, Nebraska","31","161"
"12593","9679","2292","2048","124324","30147","17838","17043","795","94177","68841","56679","12162","124324","60527","0.4467","37.6","131099","308643","266397","10414","9584","Lancaster County, Nebraska","31","109"
"101","50","0","0","1867","798","419","404","15","1069","752","713","39","1867","43388","0.4894","40.7","2445","4176","3841","6","48","Nuckolls County, Nebraska","31","129"
"3","23","0","0","283","92","76","76","0","191","155","155","0","283","51750","0.4601","45.9","415","722","671","14","7","Banner County, Nebraska","31","007"
"184","52","1","0","1135","465","254","254","0","670","530","507","23","1135","54659","0.4142","42.5","1576","2630","2357","7","13","Frontier County, Nebraska","31","063"
"12561","16080","3457","3549","218061","50409","28779","27303","1476","167652","121787","107361","14426","218061","64629","0.4696","38.9","234520","553559","463597","16389","22538","Douglas County, Nebraska","31","055"
"169","140","0","0","3704","1332","724","694","30","2372","1654","1528","126","3704","47917","0.4320","41.4","4408","7816","7099","35","0","Richardson County, Nebraska","31","147"
"310","241","19","22","4487","1493","842","809","33","2994","2253","1995","258","4487","60387","0.4177","43.4","5252","10015","9224","146","44","Holt County, Nebraska","31","089"
"144","72","3","0","2128","816","451","439","12","1312","1012","918","94","2128","48838","0.4196","40.9","2706","4670","4230","20","35","Furnas County, Nebraska","31","065"
"895","449","8","20","5157","1369","770","739","31","3788","2954","2791","163","5157","51502","0.4154","38.6","5858","14025","10777","798","668","Saline County, Nebraska","31","151"
"118","148","10","58","2176","635","397","397","0","1541","1278","1204","74","2176","51034","0.4510","40.3","2442","7145","5281","19","37","Thurston County, Nebraska","31","173"
"999","467","17","55","8185","2549","1571","1515","56","5636","4588","4232","356","8185","71430","0.4024","40.1","8564","20179","18932","47","134","Washington County, Nebraska","31","177"
"226","111","2","26","2537","893","429","412","17","1644","1349","1265","84","2537","56651","0.4124","44.0","3252","5731","5307","37","47","Cherry County, Nebraska","31","031"
"1219","823","43","22","15261","4805","2717","2569","148","10456","8150","7243","907","15261","54085","0.4173","39.5","16778","36103","31004","602","1020","Dodge County, Nebraska","31","053"
"66","105","1","1","868","338","182","180","2","530","381","341","40","868","43750","0.5025","39.9","1239","1813","1583","3","47","Garden County, Nebraska","31","069"
"196","128","0","2","1954","661","346","333","13","1293","931","853","78","1954","46194","0.4212","40.9","2441","4621","4019","27","143","Morrill County, Nebraska","31","123"
"395","238","11","0","2977","988","534","488","46","1989","1456","1337","119","2977","51828","0.4320","37.4","3501","6877","6341","54","36","Nemaha County, Nebraska","31","127"
"35","51","0","0","277","97","63","63","0","180","147","128","19","277","59432","0.4467","45.0","393","645","622","0","5","Thomas County, Nebraska","31","171"
"430","511","146","32","7404","2023","1305","1268","37","5381","4731","4116","615","7404","59231","0.3964","40.6","7840","19962","13592","1844","1972","Dakota County, Nebraska","31","043"
"304","99","21","0","2714","1015","576","573","3","1699","1291","1196","95","2714","49912","0.4039","43.0","3331","6275","5794","35","54","Antelope County, Nebraska","31","003"
"66","54","28","7","1679","556","323","304","19","1123","883","848","35","1679","57009","0.3984","42.9","1979","3716","3248","6","162","Chase County, Nebraska","31","029"
"294","113","10","5","2539","875","532","501","31","1664","1264","1175","89","2539","57173","0.3937","40.9","3007","6109","5434","58","71","Clay County, Nebraska","31","035"
"423","104","18","1","4862","1682","1006","976","30","3180","2344","2206","138","4862","52184","0.4923","42.6","5655","10713","9843","88","22","Custer County, Nebraska","31","041"
"192","70","0","8","1377","528","319","310","9","849","624","568","56","1377","49282","0.4275","41.2","1713","2924","2751","21","6","Franklin County, Nebraska","31","061"
"431","175","8","0","3713","1145","729","717","12","2568","2106","2003","103","3713","64210","0.3730","39.9","4129","9084","8510","38","5","Hamilton County, Nebraska","31","081"
"272","170","4","4","3302","1224","590","573","17","2078","1377","1257","120","3302","44510","0.4486","41.8","3921","7037","6547","69","26","Jefferson County, Nebraska","31","095"
"344","225","13","16","3882","1474","848","818","30","2408","1652","1486","166","3882","50735","0.4298","40.7","5476","8013","7173","105","97","Keith County, Nebraska","31","101"
"23","4","0","0","294","105","77","77","0","189","131","121","10","294","51000","0.3797","46.2","447","605","574","0","0","Loup County, Nebraska","31","115"
"43","134","11","1","1228","458","274","267","7","770","586","573","13","1228","65543","0.4564","42.7","1446","2868","2676","30","24","Perkins County, Nebraska","31","135"
"1087","275","26","0","8501","2692","1555","1485","70","5809","4669","4366","303","8501","68682","0.4004","39.7","9694","20855","19743","145","30","Saunders County, Nebraska","31","155"
"862","1177","43","23","14732","4722","2547","2465","82","10010","7656","6843","813","14732","49745","0.4517","40.4","16381","35501","31208","508","497","Scotts Bluff County, Nebraska","31","157"
"10","3","0","0","304","117","66","64","2","187","145","134","11","304","56500","0.4214","45.2","505","760","709","2","0","Keya Paha County, Nebraska","31","103"
"136","172","14","5","1577","626","363","305","58","951","767","717","50","1577","53403","0.4012","40.5","1924","3579","3024","21","48","Kimball County, Nebraska","31","105"
"1420","1108","49","103","14856","4449","2583","2510","73","10407","7767","7178","589","14856","59795","0.4358","40.1","16802","34858","30768","426","399","Lincoln County, Nebraska","31","111"
"330","1","100","0","2543","1180","443","443","0","1363","968","932","36","2543","25098","0.4726","38.9","4121","6975","3295","604","1259","Presidio County, Texas","48","377"
"1312","1359","985","105","15779","4983","3443","3383","60","10796","8711","8321","390","15779","46147","0.4697","40.2","19138","46047","29915","4365","3462","Val Verde County, Texas","48","465"
"99","2","1","0","580","227","147","147","0","353","264","264","0","580","37900","0.3892","41.7","968","2208","1530","114","42","Culberson County, Texas","48","109"
"7468","2899","970","272","52530","10969","6772","6545","227","41561","32179","29772","2407","52530","62973","0.4516","43.0","58393","159427","111919","5923","8162","Ector County, Texas","48","135"
"713","372","316","0","1543","569","383","347","36","974","862","830","32","1543","49627","0.4714","40.3","2044","4208","3356","94","133","Garza County, Texas","48","169"
"92","0","130","0","403","89","69","69","0","314","302","287","15","403","78456","0.4746","51.2","522","1510","1070","51","80","Glasscock County, Texas","48","173"
"1853","297","21","0","9011","3225","2128","2048","80","5786","4681","4412","269","9011","52913","0.4900","40.9","11325","24570","20144","445","553","Grimes County, Texas","48","185"
"41274","28429","9782","5790","341163","69649","49114","47554","1560","271514","219000","205170","13830","341163","96913","0.4300","40.1","363158","971106","706799","86658","76292","Collin County, Texas","48","085"
"4252","1428","226","99","31035","9513","6323","6111","212","21522","17543","16589","954","31035","50453","0.4369","40.8","36922","85265","64994","2082","2163","Angelina County, Texas","48","005"
"58","15","3","2","707","265","106","106","0","442","318","314","4","707","32305","0.4886","38.7","1145","1642","1406","0","41","Cottle County, Texas","48","101"
"18374","3569","764","655","73437","15719","11094","10664","430","57718","45636","37642","7994","73437","68717","0.4499","38.4","78715","211703","171279","5377","6622","Hays County, Texas","48","209"
"15546","5897","949","296","121523","28952","19834","19126","708","92571","74325","69755","4570","121523","81447","0.4216","41.2","136285","348786","266213","20984","12643","Brazoria County, Texas","48","039"
"190","133","0","0","1335","527","268","261","7","808","571","551","20","1335","42961","0.4584","40.4","2153","3271","2754","26","31","Donley County, Texas","48","129"
"1669","605","51","0","15546","4838","3322","3186","136","10708","9066","8656","410","15546","55366","0.4324","40.8","18467","49097","37903","717","1685","Atascosa County, Texas","48","013"
"993","218","93","0","5407","1807","1079","1063","16","3600","2728","2591","137","5407","45537","0.4788","40.9","7076","14724","11453","212","262","Nolan County, Texas","48","353"
"331","59","577","0","978","406","255","255","0","572","493","475","18","978","31677","0.4844","42.2","1579","3624","2013","234","415","Hudspeth County, Texas","48","229"
"490","458","0","1","3978","1091","723","721","2","2887","2309","2101","208","3978","62986","0.4127","43.2","4830","11552","8653","343","347","Ward County, Texas","48","475"
"2638","1026","57","0","23292","7503","5105","4642","463","15789","13086","12422","664","23292","52220","0.4785","40.6","28693","65819","53881","1207","954","Harrison County, Texas","48","203"
"45","29","0","0","1014","465","238","238","0","549","353","343","10","1014","36395","0.4737","40.0","1851","2074","1317","86","29","Menard County, Texas","48","327"
"747","193","0","0","9135","3829","2542","2430","112","5306","4352","4106","246","9135","60189","0.4481","40.1","13987","24726","20755","667","594","Fayette County, Texas","48","149"
"32443","16454","4123","2347","180160","41889","28365","27420","945","138271","111389","102537","8852","180160","87337","0.3938","39.9","192488","544319","437986","29075","26651","Williamson County, Texas","48","491"
"868","296","4","30","6929","2341","1473","1439","34","4588","3518","3358","160","6929","52524","0.4310","39.2","10643","21239","16568","306","314","Hutchinson County, Texas","48","233"
"549","82","21","0","5117","1894","1086","1000","86","3223","2406","2379","27","5117","41359","0.4449","40.3","6040","12218","10050","36","197","Morris County, Texas","48","343"
"3147","1041","60","115","31694","9359","5876","5659","217","22335","17728","16509","1219","31694","59399","0.4340","40.1","37404","83317","68612","865","628","Orange County, Texas","48","361"
"164","140","36","0","2619","625","373","366","7","1994","1544","1486","58","2619","60366","0.4091","43.1","3044","7767","5587","250","320","Winkler County, Texas","48","495"
"92619","73867","55475","55244","1605368","338867","228201","219295","8906","1266501","957947","877365","80582","1605368","61705","0.4971","40.3","1768096","4624525","2946148","363395","379899","Harris County, Texas","48","201"
"2911","487","148","23","16743","6971","4776","4606","170","9772","8094","7675","419","16743","59492","0.4426","38.2","22793","45961","37101","1133","717","Burnet County, Texas","48","053"
"1357","257","211","26","10694","5250","3223","3124","99","5444","4236","4073","163","10694","59155","0.4641","39.2","13184","26117","19719","739","592","Gillespie County, Texas","48","171"
"69696","47119","24219","33258","928341","197580","125319","119691","5628","730761","534516","479851","54665","928341","59607","0.4982","40.1","1013364","2588571","1674137","154829","215821","Dallas County, Texas","48","113"
"29","5","0","0","270","104","76","76","0","166","142","134","8","270","62000","0.4968","46.2","451","774","628","3","5","McMullen County, Texas","48","311"
"554","139","28","0","7307","2480","1649","1571","78","4827","3799","3607","192","7307","50635","0.4402","41.0","8720","17743","13743","209","341","Young County, Texas","48","503"
"6523","2078","266","70","57310","15905","11353","11020","333","41405","34418","32519","1899","57310","64359","0.4098","40.8","62000","164746","133723","2435","2340","Johnson County, Texas","48","251"
"1731","273","35","46","13424","4439","2925","2869","56","8985","7420","6884","536","13424","52078","0.4474","41.9","15381","36013","27869","685","794","Hopkins County, Texas","48","223"
"186","255","59","0","3483","779","490","469","21","2704","2246","2147","99","3483","50464","0.4268","40.9","4113","10067","6578","426","934","Ochiltree County, Texas","48","357"
"277","56","61","0","1375","474","231","227","4","901","751","735","16","1375","48798","0.4287","42.9","2033","3571","2817","44","110","Knox County, Texas","48","275"
"11413","6008","958","417","90054","25003","15974","15431","543","65051","50388","44402","5986","90054","49778","0.4732","38.3","101142","246845","198459","4998","7562","McLennan County, Texas","48","309"
"469","56","74","0","912","397","268","251","17","515","363","363","0","912","47500","0.4660","42.4","1665","2195","1887","16","13","Concho County, Texas","48","095"
"87","22","1","0","789","444","227","227","0","345","218","218","0","789","40766","0.4648","36.0","1728","1906","1465","44","22","Edwards County, Texas","48","137"
"1045","214","106","18","6492","2608","1514","1453","61","3884","2487","2411","76","6492","37276","0.5381","39.2","10386","18010","14299","310","298","Eastland County, Texas","48","133"
"46","51","43","0","1054","492","381","379","2","562","261","229","32","1054","53088","0.3305","39.9","1913","2177","1358","223","227","Jeff Davis County, Texas","48","243"
"223","0","0","15","1626","542","308","305","3","1084","906","874","32","1626","33382","0.4708","38.2","2468","5200","4014","27","41","Jim Hogg County, Texas","48","247"
"25583","11022","4355","2448","198649","50292","35436","33723","1713","148357","121932","114741","7191","198649","80902","0.4761","40.7","216836","569445","439324","22729","27164","Montgomery County, Texas","48","339"
"161","12","19","17","3148","1261","730","724","6","1887","1590","1530","60","3148","27161","0.4783","38.5","4418","10326","7818","288","94","Dimmit County, Texas","48","127"
"2166","994","3199","1274","74789","17990","13140","12855","285","56799","48716","47081","1635","74789","46475","0.4794","38.7","83041","271326","156975","16554","22668","Webb County, Texas","48","479"
"84","14","0","0","694","265","178","178","0","429","388","377","11","694","72500","0.3981","39.7","921","1909","1737","32","0","Armstrong County, Texas","48","011"
"349","89","56","38","2532","756","479","464","15","1776","1347","1274","73","2532","50142","0.4083","44.2","3194","7590","5126","287","392","Castro County, Texas","48","069"
"2173","910","235","0","10955","2789","1591","1540","51","8166","6299","5439","860","10955","43730","0.4861","38.0","13283","30046","23910","838","652","Kleberg County, Texas","48","273"
"2584","590","83","20","15351","4929","3287","3203","84","10422","8299","7617","682","15351","60202","0.4360","41.0","16928","39576","31826","735","1327","Cooke County, Texas","48","097"
"440","18","27","16","2061","737","457","443","14","1324","1043","1016","27","2061","40759","0.4343","38.0","2914","5758","4353","109","53","Crosby County, Texas","48","107"
"136","1","2","0","1601","639","282","274","8","962","770","718","52","1601","46146","0.4848","40.4","2210","3838","3282","28","46","Fisher County, Texas","48","151"
"807","0","1","3","3511","1381","837","799","38","2130","1798","1652","146","3511","41186","0.4350","39.9","5581","10754","7965","273","150","Duval County, Texas","48","131"
"389","371","51","0","4343","1800","1197","1179","18","2543","2117","1960","157","4343","66390","0.4697","40.8","5808","11384","9056","232","205","Blanco County, Texas","48","031"
"1924","310","22","7","12936","4896","2967","2884","83","8040","6216","5935","281","12936","44370","0.4717","40.4","17280","34598","28079","266","184","Jasper County, Texas","48","241"
"10828","4073","865","617","92988","25381","15344","14658","686","67607","49225","45181","4044","92988","51248","0.4776","38.6","108535","240481","178874","7186","6493","Jefferson County, Texas","48","245"
"102","117","96","9","1337","711","285","285","0","626","464","377","87","1337","26738","0.4762","40.6","1995","3386","2623","192","207","Kinney County, Texas","48","271"
"148","55","1","0","594","193","121","114","7","401","342","317","25","594","64545","0.4390","43.4","757","1669","1438","28","30","Oldham County, Texas","48","359"
"691","149","23","10","4728","1418","804","788","16","3310","2570","2477","93","4728","45111","0.4453","41.8","6074","12922","9359","329","266","Lamb County, Texas","48","279"
"95","67","3","0","1192","361","252","236","16","831","690","653","37","1192","59091","0.4363","43.4","1480","3357","2421","68","199","Lipscomb County, Texas","48","295"
"372","62","0","3","3143","1221","826","803","23","1922","1374","1265","109","3143","47707","0.4423","43.9","4333","7915","5925","121","235","McCulloch County, Texas","48","307"
"130","140","1","0","1696","798","495","445","50","898","650","630","20","1696","42276","0.5095","39.8","2769","4176","3246","31","106","Mason County, Texas","48","319"
"156","39","1","4","845","339","187","171","16","506","354","331","23","845","42540","0.5147","41.3","1357","2088","1670","21","9","Dickens County, Texas","48","125"
"351","91","0","0","3022","908","513","496","17","2114","1652","1505","147","3022","64511","0.4137","40.8","3283","7023","6617","64","16","Pierce County, Nebraska","31","139"
"25","23","0","0","544","205","120","120","0","339","280","251","29","544","48269","0.3977","43.0","803","1219","1094","19","9","Sioux County, Nebraska","31","165"
"291","107","10","3","2856","1068","608","559","49","1788","1405","1333","72","2856","54203","0.4596","40.8","3464","6415","5690","19","60","Burt County, Nebraska","31","021"
"1367","458","80","3","9945","3031","1999","1881","118","6914","5511","5104","407","9945","71846","0.3954","39.6","11527","25475","23663","180","50","Cass County, Nebraska","31","025"
"189","72","0","0","3727","1247","653","644","9","2480","1875","1770","105","3727","56768","0.4050","41.9","4240","8793","7842","130","158","Cuming County, Nebraska","31","039"
"332","36","2","0","2352","808","490","468","22","1544","1144","1101","43","2352","56905","0.4117","41.8","2716","5631","4946","115","236","Dixon County, Nebraska","31","051"
"61","203","4","1","872","322","132","129","3","550","378","348","30","872","41716","0.4011","43.4","1100","1877","1563","10","19","Dundy County, Nebraska","31","057"
"31","10","0","0","288","103","71","69","2","185","134","129","5","288","46500","0.4428","45.1","394","718","633","3","0","Grant County, Nebraska","31","075"
"66","56","5","0","1019","424","235","234","1","595","455","437","18","1019","47869","0.4146","40.9","1302","2356","2191","15","7","Greeley County, Nebraska","31","077"
"2259","1136","312","113","23096","6236","3728","3511","217","16860","13390","12201","1189","23096","57104","0.4378","39.5","24832","60411","47661","2396","3141","Hall County, Nebraska","31","079"
"23","7","2","0","403","121","63","62","1","282","209","199","10","403","51726","0.4726","45.8","529","893","772","22","25","Hayes County, Nebraska","31","085"
"798","256","7","0","6510","2078","1082","1024","58","4432","3532","3217","315","6510","59167","0.4338","40.8","7169","15717","14346","99","272","Otoe County, Nebraska","31","131"
"403","297","19","7","4519","1575","849","822","27","2944","2245","1996","249","4519","48808","0.4352","40.3","5325","10505","9533","76","36","Red Willow County, Nebraska","31","145"
"291","181","33","0","3506","1247","727","704","23","2259","1806","1670","136","3506","61869","0.3965","42.6","4169","8351","7879","9","7","Cedar County, Nebraska","31","027"
"526","680","0","0","3525","1087","693","665","28","2438","1693","1346","347","3525","50750","0.3671","37.0","4247","8737","7795","19","74","Dawes County, Nebraska","31","045"
"300","64","10","3","1809","615","350","346","4","1194","931","877","54","1809","54712","0.4168","41.2","2175","4107","3738","68","51","Johnson County, Nebraska","31","097"
"212","461","12","0","4395","1288","583","564","19","3107","2038","1882","156","4395","53871","0.4205","42.0","5014","9508","8823","39","71","Cheyenne County, Nebraska","31","033"
"919","510","217","24","8965","2635","1593","1558","35","6330","5231","4734","497","8965","53721","0.4110","39.8","10268","23462","16860","1789","2338","Dawson County, Nebraska","31","047"
"124","6","0","0","884","371","219","205","14","513","418","397","21","884","53000","0.4061","41.4","1230","1946","1858","15","0","Garfield County, Nebraska","31","071"
"17","2","0","0","191","91","37","37","0","100","79","79","0","191","48125","0.4259","41.7","241","395","375","2","0","McPherson County, Nebraska","31","117"
"137","28","0","0","1546","474","249","236","13","1072","812","745","67","1546","49032","0.4498","41.4","1856","3450","3234","2","14","Nance County, Nebraska","31","125"
"267","76","0","0","2418","702","499","426","73","1716","1377","1316","61","2418","63986","0.3545","40.0","2694","5891","5462","118","49","Stanton County, Nebraska","31","167"
"172","39","7","0","1865","744","437","433","4","1121","850","785","65","1865","55324","0.4328","41.3","2303","4153","3742","40","15","Valley County, Nebraska","31","175"
"861","1517","65","81","9940","3179","2178","1975","203","6761","5203","4596","607","9940","57824","0.4109","39.7","10947","23230","19381","677","573","Churchill County, Nevada","32","001"
"1634","2176","118","56","20741","8957","6380","5865","515","11784","9237","8343","894","20741","66810","0.4405","38.4","24399","47874","41549","1840","766","Douglas County, Nevada","32","005"
"594","385","0","21","1948","702","440","399","41","1246","985","907","78","1948","50491","0.4123","37.6","2494","4720","3910","156","97","Pershing County, Nevada","32","027"
"58","52","0","91","774","284","159","152","7","490","436","406","30","774","67105","0.4095","41.7","1226","1854","1635","21","14","Eureka County, Nevada","32","011"
"734","733","51","998","6500","1626","941","933","8","4874","3750","3372","378","6500","67756","0.4300","41.9","7552","16623","13166","720","726","Humboldt County, Nevada","32","013"
"1003","251","5","72","3516","1138","575","520","55","2378","1775","1615","160","3516","60827","0.3963","41.6","4524","8206","7449","52","73","White Pine County, Nevada","32","033"
"1251","2450","118","3448","18065","3876","2448","2381","67","14189","11088","10280","808","18065","81232","0.3806","41.1","21579","51636","42750","1964","1720","Elko County, Nevada","32","007"
"1711","2020","89","102","19088","8854","5865","5148","717","10234","6776","6008","768","19088","47300","0.4154","38.6","22404","43935","37686","1249","689","Nye County, Nevada","32","023"
"288","205","0","32","1627","729","508","434","74","898","645","603","42","1627","66292","0.4217","37.9","1973","3943","3414","73","56","Storey County, Nevada","32","029"
"4757","97107","13328","34323","783524","219023","145132","133765","11367","564501","414954","364829","50125","783524","59340","0.4671","38.6","899870","2157777","1537808","221760","144735","Clark County, Nevada","32","003"
"2449","2451","88","209","21189","8134","5431","4935","496","13055","10119","8941","1178","21189","56875","0.4011","39.2","23420","54146","46891","1440","1413","Lyon County, Nevada","32","019"
"1786","3123","214","103","30141","10205","6110","5651","459","19936","14789","12708","2081","30141","64751","0.4324","38.0","35588","75316","68236","1670","693","Cheshire County, New Hampshire","33","005"
"1941","6123","991","563","34727","11822","7346","6955","391","22905","16103","14084","2019","34727","63389","0.4847","37.4","52913","88843","78036","1985","2544","Grafton County, New Hampshire","33","009"
"4152","11406","998","1581","121045","36963","24292","22971","1321","84082","68649","61201","7448","121045","93756","0.4237","39.1","132169","304029","276832","8943","4782","Rockingham County, New Hampshire","33","015"
"803","761","37","54","17328","6022","4027","3760","267","11306","8418","7597","821","17328","61312","0.4379","39.0","22652","42620","38426","946","272","Sullivan County, New Hampshire","33","019"
"8203","16268","3275","2263","161086","43797","28406","26816","1590","117289","91460","79353","12107","161086","81460","0.4280","38.8","171192","408815","349934","20362","13284","Hillsborough County, New Hampshire","33","011"
"1001","1321","16","26","13768","5258","3091","2880","211","8510","6059","5371","688","13768","47117","0.4293","38.2","21594","29614","26583","614","272","Coos County, New Hampshire","33","007"
"1101","1370","66","21","21456","8557","5699","5307","392","12899","9617","8439","1178","21456","63153","0.4446","38.7","41168","47678","42324","681","376","Carroll County, New Hampshire","33","003"
"14602","8460","3610","13357","129936","38463","23603","22641","962","91473","70480","64827","5653","129936","81057","0.5025","37.8","144855","362670","267449","37622","29674","Mercer County, New Jersey","34","021"
"5044","1464","930","960","50729","15444","9501","8847","654","35285","27746","25666","2080","50729","54149","0.4677","36.3","56448","140369","119602","4560","3075","Cumberland County, New Jersey","34","011"
"12200","4363","2802","8955","118193","33991","22368","21570","798","84202","67735","63745","3990","118193","113611","0.4565","39.1","126717","326872","236224","48794","24648","Somerset County, New Jersey","34","035"
"15399","7905","1491","4431","226160","94158","54776","51775","3001","132002","105545","98015","7530","226160","70909","0.4487","37.7","283297","591261","522427","26219","9330","Ocean County, New Jersey","34","029"
"6467","4143","1631","6858","99850","33391","20270","18887","1383","66459","51341","47112","4229","99850","62110","0.4716","37.3","128251","263554","208162","22751","11234","Atlantic County, New Jersey","34","001"
"20661","12467","9322","39345","285005","84646","56558","54964","1594","200359","165120","154279","10841","285005","89533","0.4320","38.7","301566","817768","525361","143368","93157","Middlesex County, New Jersey","34","023"
"1872","1069","15","273","23933","8100","4798","4551","247","15833","12127","11226","901","23933","66842","0.4536","38.8","27595","61812","56973","1078","477","Salem County, New Jersey","34","033"
"2444","3195","104","699","40171","16750","10584","10106","478","23421","18044","16262","1782","40171","67074","0.4727","38.1","99312","90937","82337","1891","1233","Cape May County, New Jersey","34","009"
"11974","8310","3215","17732","187383","55857","34179","32796","1383","131526","100650","92444","8206","187383","70451","0.4712","38.3","206078","501273","424935","29248","14288","Camden County, New Jersey","34","007"
"14063","7967","4791","33378","190101","55172","35414","34072","1342","134929","108899","102905","5994","190101","80198","0.4945","38.9","202267","549538","364466","81142","41708","Union County, New Jersey","34","039"
"9407","19645","11239","149439","258591","59083","36315","34437","1878","199508","149747","126002","23745","258591","71189","0.5038","39.7","282039","665210","353462","123727","102443","Hudson County, New Jersey","34","017"
"4486","1692","462","2053","47175","15490","10382","9696","686","31685","26320","24844","1476","47175","115379","0.4346","39.1","50249","121168","107285","6910","3815","Hunterdon County, New Jersey","34","019"
"12631","7048","2762","13966","181884","56441","37008","35647","1361","125443","101643","94491","7152","181884","115527","0.4590","39.2","193339","489401","384142","54505","27622","Morris County, New Jersey","34","027"
"129","158","6","0","1679","669","415","360","55","1010","733","711","22","1679","42526","0.4711","38.8","2454","4183","3686","160","163","Hidalgo County, New Mexico","35","023"
"803","1507","86","261","20942","6489","4552","4356","196","14453","11102","10503","599","20942","33834","0.5120","37.4","26312","72087","56360","656","709","McKinley County, New Mexico","35","031"
"4767","3537","340","543","51001","16749","11704","11027","677","34252","27474","24975","2499","51001","63802","0.4209","38.2","56585","141793","123264","4491","1598","Sandoval County, New Mexico","35","043"
"394","1131","10","103","11851","5185","2995","2777","218","6666","4637","3956","681","11851","37843","0.5040","37.6","15071","27189","25374","562","248","Grant County, New Mexico","35","017"
"1367","2579","554","37","18548","4448","2408","2277","131","14100","10446","9669","777","18548","45092","0.4453","39.9","21267","46890","39625","1029","1331","Curry County, New Mexico","35","009"
"1152","148","5","31","6036","2076","1403","1367","36","3960","3225","3118","107","6036","54744","0.4459","39.1","7763","16601","13352","262","371","Lee County, Texas","48","287"
"61994","46350","15600","5692","708252","157366","104261","100375","3886","550886","430121","395450","34671","708252","67700","0.4586","40.0","767808","2033815","1501298","110531","95409","Tarrant County, Texas","48","439"
"5196","296","62","88","16677","5440","3382","3235","147","11237","8840","8367","473","16677","43455","0.4299","40.9","20476","44396","36559","843","578","Anderson County, Texas","48","001"
"7455","1499","436","190","57307","14835","10229","9931","298","42472","36790","35283","1507","57307","76871","0.4176","40.8","61722","172528","139406","3608","3529","Ellis County, Texas","48","139"
"615","130","20","95","4917","1613","1106","1098","8","3304","2665","2463","202","4917","62806","0.4191","40.8","6729","14594","11361","254","679","Jackson County, Texas","48","239"
"2423","696","77","8","21403","9610","6144","5936","208","11793","9162","8615","547","21403","55990","0.4698","39.7","24636","50996","41014","955","815","Kerr County, Texas","48","265"
"1595","209","12","32","9228","3351","2105","1958","147","5877","4498","4259","239","9228","47902","0.4624","40.1","11440","24254","20208","365","417","Milam County, Texas","48","331"
"396","51","4","0","5487","2324","1475","1396","79","3163","2442","2367","75","5487","53516","0.4129","41.3","7384","13327","10695","311","436","Comanche County, Texas","48","093"
"1430","246","0","55","5199","2033","1165","1108","57","3166","2330","2229","101","5199","39497","0.4705","39.8","7781","15526","12250","265","337","Falls County, Texas","48","145"
"686","272","190","2","2120","785","484","478","6","1335","980","948","32","2120","28333","0.4985","38.8","3117","6598","5042","62","12","Brooks County, Texas","48","047"
"1187","100","21","5","11301","3782","2632","2517","115","7519","6250","5917","333","11301","66206","0.4146","41.4","13278","29488","23584","783","1030","Austin County, Texas","48","015"
"7","1","0","0","197","106","81","81","0","91","72","72","0","197","38021","0.3216","40.7","277","568","364","57","0","Kenedy County, Texas","48","261"
"836","189","49","21","7450","3039","1822","1769","53","4411","3445","3265","180","7450","52559","0.4721","41.3","10710","20909","16533","561","687","Colorado County, Texas","48","089"
"3817","1213","198","39","22898","6854","4633","4481","152","16044","13129","12367","762","22898","56556","0.4544","40.9","28226","66220","53207","819","1068","San Patricio County, Texas","48","409"
"10113","2591","352","160","49389","13492","8434","8228","206","35897","27590","25540","2050","49389","68261","0.4263","40.0","54705","133137","114884","2669","2958","Randall County, Texas","48","381"
"472","53","31","0","2082","934","529","508","21","1148","899","821","78","2082","45083","0.4742","40.9","3191","5326","4085","51","197","San Saba County, Texas","48","411"
"21","8","0","12","1075","383","217","189","28","692","511","480","31","1075","53229","0.4140","43.0","1508","2980","2023","165","148","Schleicher County, Texas","48","413"
"255","297","26","14","3571","1246","892","848","44","2325","2107","2033","74","3571","34459","0.4146","39.1","4385","11875","9256","281","433","Zavala County, Texas","48","507"
"820","341","162","44","7582","2434","1585","1545","40","5148","3924","3590","334","7582","58776","0.4164","40.9","12012","21444","15452","947","951","Calhoun County, Texas","48","057"
"102","23","0","0","533","228","130","130","0","305","237","216","21","533","43625","0.4655","42.1","873","1239","1017","20","20","Foard County, Texas","48","155"
"371","78","0","0","2727","1044","628","606","22","1683","1382","1316","66","2727","60690","0.4791","39.9","3771","7464","6487","92","159","Goliad County, Texas","48","175"
"320","14","50","0","2989","1217","783","773","10","1772","1361","1321","40","2989","50825","0.4646","40.3","4542","8116","6597","110","80","Hamilton County, Texas","48","193"
"836","217","28","0","2382","847","558","525","33","1535","1129","989","140","2382","51492","0.4497","41.8","4079","6484","5093","101","115","Mitchell County, Texas","48","335"
"751","319","98","35","10893","3220","2331","2269","62","7673","6445","6168","277","10893","50196","0.4182","39.8","12408","32418","22341","1332","2879","Titus County, Texas","48","449"
"1298","170","46","0","7826","3108","1915","1889","26","4718","3886","3720","166","7826","54403","0.4715","41.7","10479","19582","17020","184","396","Lavaca County, Texas","48","285"
"1001","145","65","13","4061","1319","826","820","6","2742","2192","2055","137","4061","44627","0.4333","43.4","4857","11535","8259","304","305","Terry County, Texas","48","445"
"4434","611","93","52","22369","6559","4495","4309","186","15810","13106","12544","562","22369","64536","0.4215","40.6","24796","65372","50958","1270","1434","Wise County, Texas","48","497"
"1071","253","204","129","13848","4153","2601","2526","75","9695","6932","6736","196","13848","48913","0.4668","40.2","19554","36305","27830","932","1031","Matagorda County, Texas","48","321"
"1082","50","18","10","4656","1317","883","883","0","3339","2586","2456","130","4656","52397","0.4491","42.2","5754","13542","9938","559","595","Pecos County, Texas","48","371"
"6739","1790","611","383","33032","8221","5785","5605","180","24811","21802","20990","812","33032","100920","0.3996","40.8","34268","96467","79435","3447","2479","Rockwall County, Texas","48","397"
"7522","3732","956","395","49868","13432","8434","8044","390","36436","28285","24696","3589","49868","53143","0.4533","39.3","57456","131204","106759","2940","3183","Taylor County, Texas","48","441"
"109","39","2","0","668","281","159","156","3","387","279","268","11","668","40000","0.5012","41.8","1028","1432","1201","3","0","Throckmorton County, Texas","48","447"
"7184","1274","216","133","21963","5759","3656","3609","47","16204","12013","9516","2497","21963","43742","0.4711","37.9","26164","58240","47003","1171","2323","Walker County, Texas","48","471"
"3235","1142","82","40","16510","7627","5126","4850","276","8883","6976","6792","184","16510","53394","0.4730","40.3","21264","43361","36565","585","514","Wood County, Texas","48","499"
"1633","479","335","19","9548","4350","2741","2636","105","5198","3798","3496","302","9548","45137","0.5348","36.9","16165","24093","18019","699","568","Aransas County, Texas","48","007"
"69","65","15","2","998","312","179","174","5","686","521","513","8","998","40962","0.4679","46.3","1347","2863","1922","49","109","Cochran County, Texas","48","079"
"237","21","0","0","1644","646","348","343","5","998","694","664","30","1644","45000","0.3885","42.4","2703","3206","2652","75","4","Coke County, Texas","48","081"
"5817","5205","1162","93","22322","5306","3154","3056","98","17016","13823","12919","904","22322","52893","0.4227","43.0","26689","57995","48422","1961","1392","Coryell County, Texas","48","099"
"85","271","0","0","1298","320","219","215","4","978","854","820","34","1298","70625","0.4392","42.8","1729","3958","2768","91","159","Hemphill County, Texas","48","211"
"281","107","117","25","6733","1601","1081","1016","65","5132","4197","4052","145","6733","54871","0.3756","43.6","8067","21242","13803","1134","2640","Moore County, Texas","48","341"
"6647","1213","447","215","44380","10727","6045","5787","258","33653","24566","22747","1819","44380","42528","0.4772","40.0","49951","112967","77619","4450","5946","Potter County, Texas","48","375"
"474","133","92","0","3451","1515","1015","988","27","1936","1503","1498","5","3451","40353","0.5069","40.1","5455","8050","6773","44","41","San Augustine County, Texas","48","405"
"182","9","0","0","1317","435","291","291","0","882","657","579","78","1317","46935","0.4317","38.7","1781","3270","2773","41","36","Shackelford County, Texas","48","417"
"814","165","411","58","16188","4887","3294","3246","48","11301","9817","9723","94","16188","30387","0.5096","37.6","19796","63545","31993","3848","5617","Starr County, Texas","48","427"
"135","26","33","6","1332","457","282","259","23","875","645","604","41","1332","52171","0.4365","43.6","1686","3602","2934","111","152","Upton County, Texas","48","461"
"1989","158","36","41","14409","4986","2910","2741","169","9423","7411","6831","580","14409","48365","0.4767","40.0","18979","36785","30202","668","596","Brown County, Texas","48","049"
"139","31","8","1","1267","471","251","242","9","796","595","561","34","1267","34673","0.4961","41.6","1916","2993","2152","29","83","Hall County, Texas","48","191"
"512","141","28","29","3965","1573","945","900","45","2392","2002","1917","85","3965","53783","0.4516","42.1","5827","10622","8720","137","270","Franklin County, Texas","48","159"
"1564","108","1767","0","4542","1677","1190","1170","20","2865","2247","2202","45","4542","46729","0.5087","41.1","5993","15664","11629","493","167","Frio County, Texas","48","163"
"683","330","31","0","7807","2624","1750","1680","70","5183","4230","4090","140","7807","60772","0.4147","39.4","9401","20512","17001","344","488","Lampasas County, Texas","48","281"
"509","384","50","33","11779","4148","2454","2278","176","7631","5817","5239","578","11779","49168","0.4341","39.2","17545","26204","24293","567","415","Orleans County, Vermont","50","019"
"253","107","16","17","2956","994","669","620","49","1962","1549","1395","154","2956","71587","0.4440","39.6","5290","7016","6465","227","73","Grand Isle County, Vermont","50","013"
"4221","8500","1564","2539","66160","17150","9860","9043","817","49010","37160","28424","8736","66160","73647","0.4483","37.2","69734","161285","142423","7210","6723","Chittenden County, Vermont","50","007"
"733","832","57","77","10546","3107","2027","1731","296","7439","5627","4866","761","10546","64003","0.4880","38.2","13681","25244","23332","320","341","Lamoille County, Vermont","50","015"
"1119","625","41","99","18563","5411","3060","2861","199","13152","10530","9615","915","18563","65485","0.4010","39.5","22562","48679","45522","890","399","Franklin County, Vermont","50","011"
"1010","860","26","17","12434","4289","2569","2408","161","8145","6136","5250","886","12434","50563","0.4595","38.3","16380","29807","27803","385","262","Caledonia County, Vermont","50","005"
"565","1701","121","244","18943","6810","3704","3368","336","12133","8576","7353","1223","18943","51985","0.4672","36.8","30586","42382","38943","758","478","Windham County, Vermont","50","025"
"621","1131","83","95","14581","5628","3267","2925","342","8953","6711","6084","627","14581","56183","0.4714","36.6","21153","35298","32730","652","382","Bennington County, Vermont","50","003"
"1089","1581","227","102","14584","4968","3077","2844","233","9616","7328","6406","922","14584","68825","0.4068","37.6","17431","36634","33473","780","789","Addison County, Vermont","50","001"
"183","182","4","9","2740","1156","661","613","48","1584","1183","1101","82","2740","44349","0.4179","38.2","5167","6200","5732","150","78","Essex County, Vermont","50","009"
"997","1715","97","203","21251","5964","3743","3616","127","15287","12211","11482","729","21251","65328","0.4322","41.8","24576","57132","48973","1217","1519","Eddy County, New Mexico","35","015"
"66","5","0","0","1713","867","628","500","128","846","455","338","117","1713","28446","0.4764","33.7","2981","4536","4262","31","15","Mora County, New Mexico","35","033"
"1090","3561","223","163","43387","13061","8862","8411","451","30326","23758","22238","1520","43387","50518","0.4462","39.3","51113","125242","106034","995","1343","San Juan County, New Mexico","35","045"
"294","109","0","32","3149","1015","630","619","11","2134","1499","1463","36","3149","36258","0.4587","40.0","4256","8156","6873","25","11","Benton County, Mississippi","28","009"
"167","50","0","0","2928","987","681","657","24","1941","1489","1439","50","2928","40219","0.4748","39.2","4269","7655","6904","15","11","Franklin County, Mississippi","28","037"
"418","391","0","49","8782","2454","1521","1456","65","6328","4449","4181","268","8782","29121","0.5442","37.2","10711","22938","19871","41","33","Coahoma County, Mississippi","28","027"
"543","67","10","0","6629","2286","1628","1604","24","4343","3156","3142","14","6629","35872","0.4861","40.5","8409","16451","14254","43","0","Jasper County, Mississippi","28","061"
"1770","372","8","37","24858","7982","4867","4706","161","16876","13103","12281","822","24858","41775","0.4806","40.0","29095","67560","59135","166","553","Jones County, Mississippi","28","067"
"415","312","0","0","5601","1986","989","962","27","3615","2488","2409","79","5601","30961","0.5542","41.7","7282","14343","11976","9","22","Walthall County, Mississippi","28","147"
"858","127","17","24","13966","4731","2623","2588","35","9235","6880","6534","346","13966","42354","0.4638","39.8","16561","35195","31530","35","53","Monroe County, Mississippi","28","095"
"1046","466","23","10","10783","3133","2071","1999","72","7650","6241","5944","297","10783","44759","0.4259","40.5","12895","31368","26059","79","274","Pontotoc County, Mississippi","28","115"
"433","130","19","43","6188","1844","1074","1056","18","4344","2798","2666","132","6188","21504","0.5747","38.1","8554","17560","14705","16","4","Holmes County, Mississippi","28","051"
"302","69","21","123","5218","2087","1119","1116","3","3131","2410","2285","125","5218","33981","0.5130","42.0","6789","12304","10614","16","20","Amite County, Mississippi","28","005"
"5207","1862","287","155","39635","9315","6133","5978","155","30320","23375","22219","1156","39635","71824","0.4737","40.2","43218","103563","92989","2227","1238","Madison County, Mississippi","28","089"
"372","60","0","0","5846","1895","1099","1059","40","3951","2836","2693","143","5846","37263","0.4152","40.9","7007","14307","12418","77","119","Calhoun County, Mississippi","28","013"
"818","367","21","52","9483","3289","1776","1741","35","6194","4310","4122","188","9483","32090","0.4924","41.1","12060","24250","20416","36","86","Marion County, Mississippi","28","091"
"354","160","64","0","7635","2826","1647","1645","2","4809","3738","3390","348","7635","37681","0.4430","40.2","10428","19202","16490","13","59","Tishomingo County, Mississippi","28","141"
"644","175","19","77","7683","2582","1449","1371","78","5101","4173","4019","154","7683","37706","0.5072","43.1","9440","20251","18280","53","48","Wayne County, Mississippi","28","153"
"1390","183","50","0","3925","1282","673","661","12","2643","2196","1963","233","3925","49677","0.4195","43.6","5166","9795","8025","12","200","Greene County, Mississippi","28","041"
"1327","539","7","47","12772","4356","3035","2906","129","8416","6278","5926","352","12772","42233","0.4511","39.8","15547","34141","29482","113","78","Marshall County, Mississippi","28","093"
"88","11","2","0","3027","953","570","533","37","2074","1397","1300","97","3027","25283","0.4643","38.0","3581","7017","5778","18","0","Quitman County, Mississippi","28","119"
"1072","2598","72","1","21020","7188","4841","4701","140","13832","10871","10377","494","21020","46901","0.4381","40.0","25386","54450","46164","353","196","Pearl River County, Mississippi","28","109"
"858","275","51","30","8105","2643","1520","1478","42","5462","4275","4113","162","8105","37096","0.4923","41.9","9567","22145","18660","62","79","Leake County, Mississippi","28","079"
"872","373","39","45","10657","3117","1902","1831","71","7540","5619","5353","266","10657","37987","0.4670","40.1","12535","28854","25149","70","148","Neshoba County, Mississippi","28","099"
"8017","3342","345","6","55909","15629","9744","9500","244","40280","32201","30270","1931","55909","65996","0.4082","40.1","60483","147374","130639","1675","1312","Rankin County, Mississippi","28","121"
"754","664","85","15","17988","5546","3295","3148","147","12442","8714","8084","630","17988","29705","0.5365","38.4","21591","45604","38181","119","162","Washington County, Mississippi","28","151"
"491","119","10","40","4849","1592","964","957","7","3257","2541","2428","113","4849","41914","0.4585","40.3","6173","12633","11079","27","0","Lawrence County, Mississippi","28","077"
"651","184","11","0","4623","1471","1019","1012","7","3152","2434","2335","99","4623","42469","0.4848","42.9","5658","11891","10149","69","22","Perry County, Mississippi","28","111"
"540","224","23","0","6476","2080","1160","1141","19","4396","3234","3137","97","6476","36548","0.4516","39.2","7596","16744","14542","67","87","Chickasaw County, Mississippi","28","017"
"220","70","0","0","3827","1441","1004","966","38","2386","1817","1719","98","3827","46052","0.4482","40.8","5181","9843","9082","0","0","Carroll County, Mississippi","28","015"
"558","288","10","74","7592","2418","1449","1402","47","5174","3993","3907","86","7592","47292","0.4574","39.9","9527","23369","19077","43","62","George County, Mississippi","28","039"
"641","199","0","21","8391","2683","1462","1402","60","5708","4234","3960","274","8391","40122","0.4692","39.3","10243","20740","18283","0","22","Grenada County, Mississippi","28","043"
"174","60","0","0","2448","905","627","627","0","1543","866","861","5","2448","25019","0.4939","38.0","3770","6722","5489","110","52","Jefferson County, Mississippi","28","063"
"832","124","20","24","8037","2579","1548","1518","30","5458","4289","4179","110","8037","35958","0.4667","39.7","9508","21220","18650","135","42","Newton County, Mississippi","28","101"
"981","110","6","4","9145","3097","1876","1791","85","6048","4533","4301","232","9145","39256","0.4654","39.8","11206","24968","21516","142","307","Prentiss County, Mississippi","28","117"
"125","10","0","14","1751","599","442","388","54","1152","689","658","31","1751","29394","0.4998","39.7","2150","4302","3529","6","0","Sharkey County, Mississippi","28","125"
"344","25","0","11","3228","1298","661","657","4","1930","1380","1353","27","3228","36777","0.4758","40.9","4195","8145","7449","2","0","Choctaw County, Mississippi","28","019"
"1091","1355","93","64","20036","6985","4282","4093","189","13051","9855","8988","867","20036","48119","0.4526","39.5","25261","46762","39901","619","190","Hancock County, Mississippi","28","045"
"1368","175","0","12","8653","2797","1956","1897","59","5856","4699","4310","389","8653","44567","0.4215","39.4","10298","23193","20788","0","31","Itawamba County, Mississippi","28","057"
"205","13","0","1","483","176","92","72","20","307","211","202","9","483","24208","0.5659","40.4","565","1063","939","0","0","Issaquena County, Mississippi","28","055"
"2608","2886","532","94","52423","15719","9571","9245","326","36704","27517","25436","2081","52423","51657","0.4623","39.4","62121","140638","117644","2560","1331","Jackson County, Mississippi","28","059"
"412","345","35","82","9962","2879","1414","1373","41","7083","4871","4677","194","9962","26735","0.5857","38.9","13126","28704","24142","145","245","Leflore County, Mississippi","28","083"
"303","161","9","0","3930","915","538","526","12","3015","2109","1821","288","3930","39370","0.5046","40.8","4915","9873","8113","52","218","Tunica County, Mississippi","28","143"
"185","124","86","29","2908","1090","741","702","39","1818","1240","1195","45","2908","29338","0.4696","37.4","4336","9034","7612","0","16","Claiborne County, Mississippi","28","021"
"7508","12454","713","282","78104","21716","13367","12836","531","56388","42578","38744","3834","78104","47894","0.4602","39.3","92687","196504","160644","3663","2410","Harrison County, Mississippi","28","047"
"2125","2127","101","2","29736","9144","5405","5202","203","20592","14882","14105","777","29736","42534","0.5040","39.4","35297","72843","64397","288","307","Lauderdale County, Mississippi","28","075"
"924","308","15","90","12699","3955","2403","2359","44","8744","6975","6695","280","12699","42606","0.4762","39.1","15581","33802","28872","44","48","Lincoln County, Mississippi","28","085"
"1498","267","36","0","9486","3313","1943","1912","31","6173","4981","4705","276","9486","43850","0.4773","40.8","12175","26317","22350","174","77","Simpson County, Mississippi","28","127"
"1158","182","1","26","7269","2725","1685","1621","64","4544","3177","3116","61","7269","34724","0.5275","39.4","8755","17766","15424","6","0","Winston County, Mississippi","28","159"
"768","130","31","84","6941","2490","1507","1430","77","4451","3396","3305","91","6941","33767","0.5098","40.1","9239","18137","16131","69","18","Attala County, Mississippi","28","007"
"6070","1970","94","33","22116","5475","3454","3402","52","16641","13269","12182","1087","22116","60328","0.4635","40.0","24569","61301","52036","787","414","Lamar County, Mississippi","28","073"
"2995","1444","80","15","32099","9002","5460","5325","135","23097","17440","16314","1126","32099","50559","0.4674","39.8","36790","84122","73495","333","679","Lee County, Mississippi","28","081"
"189","721","22","66","4369","1407","767","704","63","2962","2225","2071","154","4369","29864","0.5244","38.8","5635","11799","10307","13","26","Tallahatchie County, Mississippi","28","135"
"465","15","29","13","5820","2044","1188","1183","5","3776","3030","2926","104","5820","43105","0.4958","41.0","7377","15921","13582","93","17","Smith County, Mississippi","28","129"
"552","626","208","47","18235","5397","3090","3021","69","12838","9097","8459","638","18235","45113","0.4855","39.1","22062","46002","39819","461","248","Warren County, Mississippi","28","149"
"224","276","9","6","6237","2149","1354","1337","17","4088","3147","3060","87","6237","43207","0.4894","44.3","8000","15709","14268","60","0","Clarke County, Mississippi","28","023"
"242","62","0","0","4539","1593","897","894","3","2946","2314","2170","144","4539","39840","0.5070","41.4","5704","9937","8937","0","77","Montgomery County, Mississippi","28","097"
"3650","2046","277","116","17798","3870","2314","2301","13","13928","9798","6962","2836","17798","40453","0.5373","34.7","21912","49138","42728","491","1316","Oktibbeha County, Mississippi","28","105"
"1114","1648","139","298","24828","7795","4370","4014","356","17033","12442","10920","1522","24828","62791","0.4382","37.7","30760","57826","54386","1053","570","Washington County, Vermont","50","023"
"359","216","69","16","4337","1413","929","928","1","2924","2579","2491","88","4337","62242","0.4098","37.6","5084","12714","10434","252","313","Millard County, Utah","49","027"
"4326","1136","199","403","20478","4291","2831","2788","43","16187","14202","13624","578","20478","74562","0.3425","38.8","21959","66977","59847","1081","1210","Tooele County, Utah","49","045"
"4796","7353","555","361","57144","22486","15342","14797","545","34658","29773","27577","2196","57144","59839","0.4459","36.5","68789","164418","137454","3081","1997","Washington County, Utah","49","053"
"180","694","13","2","2643","1058","667","649","18","1585","1082","854","228","2643","47044","0.4346","36.0","6027","7372","6137","210","14","Kane County, Utah","49","025"
"986","1947","303","468","14220","3262","2407","2283","124","10958","9111","8412","699","14220","102958","0.4996","38.8","28026","40943","35470","1277","1446","Summit County, Utah","49","043"
"144","80","2","3","4191","1252","731","729","2","2939","2194","1971","223","4191","51557","0.3981","38.3","5440","9575","7549","136","252","Grand County, Utah","49","019"
"37","30","0","7","532","291","195","193","2","241","190","186","4","532","42813","0.4068","35.7","950","1831","1468","2","0","Piute County, Utah","49","031"
"11","38","0","21","635","235","152","149","3","400","351","348","3","635","57902","0.4211","38.0","3034","2384","2024","4","97","Rich County, Utah","49","033"
"1930","1833","125","34","9879","2301","1776","1747","29","7578","6339","5805","534","9879","85166","0.4286","38.2","13221","31563","27440","878","686","Wasatch County, Utah","49","051"
"128","130","14","2","2282","663","357","357","0","1619","1357","1322","35","2282","55221","0.3921","38.7","3023","6460","5346","116","178","Beaver County, Utah","49","001"
"2185","1072","189","94","17569","4748","3241","3166","75","12821","10924","10609","315","17569","62233","0.3753","36.9","18862","53576","48201","814","512","Box Elder County, Utah","49","003"
"2457","2415","227","18","17015","4365","2942","2813","129","12650","10582","9540","1042","17015","51807","0.4397","35.6","21231","50814","43687","668","748","Iron County, Utah","49","021"
"3097","994","128","58","8643","2687","1832","1804","28","5956","5088","4824","264","8643","53838","0.4130","34.4","10770","27355","23796","369","365","Sanpete County, Utah","49","039"
"1019","443","41","39","7364","2275","1484","1473","11","5089","4351","4093","258","7364","54799","0.4135","37.4","8816","20963","18446","131","28","Sevier County, Utah","49","041"
"11437","5194","1325","2032","83632","19929","12902","12539","363","63703","52341","48501","3840","83632","67244","0.4004","38.1","91756","248664","214915","5909","5804","Weber County, Utah","49","057"
"328","286","21","39","4311","1403","943","930","13","2908","2383","2282","101","4311","45394","0.4812","39.0","5994","15058","11666","7","81","San Juan County, Utah","49","037"
"24176","34065","8531","21435","374820","83356","54847","52858","1989","291464","234706","209138","25568","374820","74865","0.4335","38.2","397080","1126121","906183","49044","52735","Salt Lake County, Utah","49","035"
"34","10","0","2","163","48","44","44","0","115","82","82","0","163","75417","0.3299","38.6","1276","517","505","0","0","Daggett County, Utah","49","009"
"97","56","3","0","1000","380","209","199","10","620","490","475","15","1000","44245","0.3939","42.0","1677","2653","2204","14","24","Wayne County, Utah","49","055"
"937","432","40","40","7829","2421","1496","1464","32","5408","4156","3870","286","7829","51158","0.4161","37.3","9828","20107","17823","124","256","Carbon County, Utah","49","007"
"347","326","35","19","3365","811","684","668","16","2554","2347","2308","39","3365","91341","0.3703","37.2","3574","11664","10701","153","116","Morgan County, Utah","49","029"
"5114","4148","1349","1308","38393","7634","5212","5121","91","30759","26957","23736","3221","38393","59038","0.4268","35.0","41388","123426","109076","2484","3663","Cache County, Utah","49","005"
"649","319","10","8","3464","918","583","576","7","2546","2324","2242","82","3464","61463","0.3722","37.1","3758","11163","9692","41","115","Juab County, Utah","49","023"
"3702","3006","489","246","28920","11662","8137","7953","184","17258","13638","12747","891","28920","87678","0.4354","38.9","33284","73345","64950","2739","1303","James City County, Virginia","51","095"
"757","196","2","1","10812","4086","2365","2220","145","6726","5120","4825","295","10812","39758","0.4660","37.8","13547","26905","24082","131","74","Russell County, Virginia","51","167"
"1112","542","0","99","12686","4560","2674","2623","51","8126","6205","5793","412","12686","40932","0.4302","38.0","15398","30115","26928","40","185","Smyth County, Virginia","51","173"
"5401","2691","789","1790","18617","3983","2242","1976","266","14634","9937","6491","3446","18617","59471","0.5377","36.6","20642","46679","38168","2034","2540","Charlottesville city, Virginia","51","540"
"2431","693","91","60","23071","8002","4502","4333","169","15069","11805","10893","912","23071","49664","0.4295","38.8","25872","54704","48754","555","459","Campbell County, Virginia","51","031"
"15995","6166","3294","1727","128464","35761","20698","19592","1106","92703","68092","61255","6837","128464","70307","0.4605","39.2","137141","325010","266102","18106","16196","Henrico County, Virginia","51","087"
"1219","1170","150","244","9202","2240","1676","1589","87","6962","5841","5344","497","9202","94274","0.3712","38.9","10078","25663","23658","385","212","King George County, Virginia","51","099"
"500","178","23","12","5062","2643","1650","1596","54","2419","1668","1593","75","5062","53711","0.5079","39.4","7625","10613","9314","166","77","Lancaster County, Virginia","51","103"
"567","617","19","10","9149","3496","2020","1946","74","5653","4166","3903","263","9149","32888","0.4932","37.0","11798","22459","19630","73","16","Lee County, Virginia","51","105"
"552","140","3","13","3920","1989","1233","1122","111","1931","1559","1329","230","3920","64237","0.4385","40.1","5751","8685","7512","132","0","Mathews County, Virginia","51","115"
"841","208","76","0","4603","2302","1390","1312","78","2301","1647","1498","149","4603","57438","0.4487","38.1","7320","10333","9214","97","92","Middlesex County, Virginia","51","119"
"2622","2505","377","46","11507","3487","2395","2303","92","8020","6601","6021","580","11507","71912","0.3902","39.5","12475","32853","29731","675","289","Prince George County, Virginia","51","149"
"1145","161","26","41","3069","1176","781","745","36","1893","1452","1378","74","3069","49517","0.4466","38.8","3962","7267","6571","97","98","Richmond County, Virginia","51","159"
"630","450","14","19","8773","3473","2049","1997","52","5300","3794","3497","297","8773","39820","0.4596","38.0","11964","21126","18950","76","89","Scott County, Virginia","51","169"
"5726","2759","298","1763","44436","12302","8927","8540","387","32134","27045","25251","1794","44436","88628","0.3919","38.8","47655","131998","114996","4491","2275","Spotsylvania County, Virginia","51","177"
"284","143","22","45","6091","2044","1460","1445","15","4047","3315","3081","234","6091","58696","0.4331","39.5","7314","15633","14169","63","60","Appomattox County, Virginia","51","011"
"1830","693","62","122","22997","9064","6101","5870","231","13933","11296","10442","854","22997","56254","0.4591","38.8","29898","55845","49752","492","376","Franklin County, Virginia","51","067"
"462","143","0","0","2707","1212","716","633","83","1495","1147","1060","87","2707","63982","0.4208","38.5","3489","7042","6536","42","3","King and Queen County, Virginia","51","097"
"6340","3950","1412","1911","35685","8077","5149","4990","159","27608","20737","14632","6105","35685","57977","0.4951","35.1","40264","97474","84491","2405","4588","Montgomery County, Virginia","51","121"
"1632","567","0","45","7961","2630","1821","1730","91","5331","4577","4393","184","7961","87904","0.3731","39.5","8480","21097","19506","363","170","New Kent County, Virginia","51","127"
"278","67","88","4","3975","1623","1028","976","52","2352","1805","1615","190","3975","47469","0.4203","38.8","4723","9814","8478","100","0","Cumberland County, Virginia","51","049"
"272","100","11","7","5778","2148","1346","1327","19","3630","2623","2492","131","5778","29932","0.6002","38.6","7577","14280","12942","6","29","Dickenson County, Virginia","51","051"
"592","405","61","44","14158","5968","3362","3256","106","8190","6288","5973","315","14158","42669","0.4415","40.2","18212","33813","29879","287","357","Halifax County, Virginia","51","083"
"14127","9706","3924","7668","128637","24946","17947","17163","784","103691","88980","83242","5738","128637","142299","0.3866","39.6","133063","392980","286751","53382","30321","Loudoun County, Virginia","51","107"
"17506","12546","4588","11803","142000","29697","21709","20987","722","112303","93952","88642","5310","142000","107132","0.3875","39.1","148874","453557","319579","52204","31414","Prince William County, Virginia","51","153"
"1059","127","29","38","6562","2240","1416","1379","37","4322","3493","3340","153","6562","61348","0.3925","38.9","7627","16377","15210","47","18","Southampton County, Virginia","51","175"
"28","3","0","0","1078","577","385","374","11","501","377","339","38","1078","48587","0.4184","35.9","2006","2204","1961","6","0","Highland County, Virginia","51","091"
"2193","1123","35","61","10946","3508","2424","2327","97","7438","6014","5502","512","10946","65103","0.4080","40.6","12268","28082","25352","491","147","Caroline County, Virginia","51","033"
"1095","408","94","71","14786","4886","3373","3117","256","9900","7954","7349","605","14786","70537","0.3828","39.4","16571","36644","33662","413","118","Gloucester County, Virginia","51","073"
"512","391","28","0","7755","3319","1949","1863","86","4436","3302","3159","143","7755","43073","0.4321","40.6","10224","17384","15370","145","53","Patrick County, Virginia","51","141"
"1956","231","50","0","10265","3425","2586","2503","83","6840","5901","5524","377","10265","89090","0.3764","40.0","10893","26235","24230","259","165","Powhatan County, Virginia","51","145"
"1622","1218","467","50","17402","6532","3980","3784","196","10870","8261","7566","695","17402","57252","0.4119","38.9","21221","42902","37803","773","814","Shenandoah County, Virginia","51","171"
"3674","1153","259","431","24562","7710","5178","4840","338","16852","14047","13178","869","24562","100783","0.4107","39.6","26894","69323","61054","1874","1155","Fauquier County, Virginia","51","061"
"2359","692","116","95","10597","3776","1933","1790","143","6821","4751","4248","503","10597","52611","0.4382","38.5","11824","23830","20819","331","352","Staunton city, Virginia","51","790"
"1514","359","37","34","9923","3534","2435","2305","130","6389","5255","4794","461","9923","76873","0.4488","38.8","10948","25206","22678","468","354","Fluvanna County, Virginia","51","065"
"221","35","0","11","3782","1146","657","620","37","2636","2127","2067","60","3782","45730","0.4255","38.9","4857","9682","8637","31","0","Webster County, Mississippi","28","155"
"777","620","60","17","14649","5010","2926","2829","97","9639","7298","6761","537","14649","42086","0.4654","40.7","17268","36431","31098","197","151","Alcorn County, Mississippi","28","003"
"338","219","0","0","7618","2387","1481","1481","0","5231","3551","3360","191","7618","31833","0.5082","38.3","9289","19384","17013","32","36","Clay County, Mississippi","28","025"
"302","40","76","33","6759","1920","1373","1325","48","4839","3740","3640","100","6759","38178","0.4543","40.5","8690","18702","16086","9","22","Covington County, Mississippi","28","031"
"153","45","24","29","3186","1043","652","645","7","2143","1547","1433","114","3186","28962","0.5413","39.4","3819","8299","6913","9","24","Humphreys County, Mississippi","28","053"
"12078","6302","1853","2931","112212","33211","19420","18352","1068","79001","57457","51253","6204","112212","60715","0.4511","39.3","124324","272284","239424","9498","8830","Dauphin County, Pennsylvania","42","043"
"3102","2525","317","185","60438","20250","12962","12505","457","40188","31904","29565","2339","60438","63379","0.4126","39.4","65503","152824","134822","2378","1848","Franklin County, Pennsylvania","42","055"
"1666","2318","344","38","14533","5431","3079","2990","89","9102","6935","6500","435","14533","59399","0.4563","36.6","17357","39694","34842","513","341","Union County, Pennsylvania","42","119"
"1970","1153","60","143","18841","7697","4893","4694","199","11144","8616","7878","738","18841","56096","0.4179","37.8","32299","47847","44133","830","293","Wayne County, Pennsylvania","42","127"
"975","717","47","127","19882","7551","4580","4380","200","12331","9647","8796","851","19882","50509","0.4138","38.8","24360","47890","44277","146","204","Bedford County, Pennsylvania","42","009"
"4038","4820","686","3425","57098","18870","13139","12331","808","38228","30481","28081","2400","57098","63934","0.4208","37.6","81485","166996","141222","10945","3988","Monroe County, Pennsylvania","42","089"
"1856","581","59","40","16779","6269","3880","3692","188","10510","8493","7863","630","16779","51678","0.4140","37.8","22696","41136","38822","217","292","Huntingdon County, Pennsylvania","42","061"
"7395","3116","350","1370","84948","29493","18057","17373","684","55455","41894","37992","3902","84948","63543","0.4560","39.2","95934","205437","194099","2151","1259","Washington County, Pennsylvania","42","125"
"27267","38107","13713","170411","601337","159066","85587","80313","5274","442271","290074","245603","44471","601337","45927","0.5182","38.4","685956","1565323","1259510","103611","74694","Philadelphia County, Pennsylvania","42","101"
"8693","8473","1924","1784","172421","53087","33790","31884","1906","119334","96005","87093","8912","172421","66457","0.4142","39.2","184135","440478","402631","9077","6290","York County, Pennsylvania","42","133"
"7015","1127","329","217","33246","10881","6786","6626","160","22365","16979","14496","2483","33246","49320","0.4553","37.9","38970","83664","76153","518","660","Indiana County, Pennsylvania","42","063"
"13267","7217","1565","857","99804","30742","18731","17727","1004","69062","51451","46277","5174","99804","71269","0.4233","38.6","106028","242092","214905","7583","6220","Cumberland County, Pennsylvania","42","041"
"22717","27102","7893","58491","541541","165545","87394","82805","4589","375996","257488","220342","37146","541541","61043","0.4852","38.7","600399","1207932","1095770","32094","33720","Allegheny County, Pennsylvania","42","003"
"8818","3382","494","2171","152283","54788","32714","31333","1381","97495","73934","67827","6107","152283","60471","0.4462","38.4","170442","349436","332385","3612","1489","Westmoreland County, Pennsylvania","42","129"
"853","70","19","1","1839","1057","620","590","30","782","558","489","69","1839","39717","0.3920","35.4","8608","3622","3457","18","7","Forest County, Pennsylvania","42","053"
"3636","1145","234","640","52126","17756","10289","9795","494","34370","26019","23599","2420","52126","49181","0.4482","38.3","56847","121711","114562","1088","245","Blair County, Pennsylvania","42","013"
"2288","1396","55","379","37055","13251","7782","7495","287","23804","18089","16832","1257","37055","50204","0.4622","38.8","41259","85690","80191","863","389","Lawrence County, Pennsylvania","42","073"
"785","1238","90","50","25021","8913","5482","5196","286","16108","12724","11601","1123","25021","52358","0.4389","39.9","30660","60377","55274","507","551","Bradford County, Pennsylvania","42","015"
"3435","1703","314","656","56674","20884","12133","11641","492","35790","25968","23639","2329","56674","46659","0.4348","37.8","65951","129775","123194","698","389","Cambria County, Pennsylvania","42","021"
"17705","11980","2257","7052","190980","56386","36862","35298","1564","134594","109728","99905","9823","190980","100214","0.4614","39.1","200402","514666","447118","21061","19377","Chester County, Pennsylvania","42","029"
"11672","5738","1881","3121","154712","48845","30643","29163","1480","105867","84875","77284","7591","154712","63728","0.4398","38.7","167105","413205","362654","14596","11356","Berks County, Pennsylvania","42","011"
"1226","246","62","9","19043","6643","4260","4148","112","12400","9957","9081","876","19043","50219","0.4121","38.5","21854","45674","39699","228","145","Mifflin County, Pennsylvania","42","087"
"72","112","6","0","1271","507","299","268","31","764","538","514","24","1271","47298","0.4129","40.4","2122","3584","2934","42","36","Mercer County, Missouri","29","129"
"847","593","34","0","7063","2481","1517","1429","88","4582","3570","3320","250","7063","34776","0.4770","38.7","8684","18017","14486","45","51","Wright County, Missouri","29","229"
"10586","7915","917","510","91238","23176","14280","13587","693","68062","52362","47194","5168","91238","70510","0.4128","39.4","97868","240958","212838","6968","3029","Clay County, Missouri","29","047"
"400","252","48","17","6371","2347","1409","1317","92","4024","2904","2802","102","6371","42100","0.4537","38.3","7334","15373","12987","121","25","Dent County, Missouri","29","065"
"819","448","207","7","8272","2652","1557","1488","69","5620","4056","3694","362","8272","44720","0.4346","38.8","10182","22525","19507","410","661","Saline County, Missouri","29","195"
"69","13","2","4","859","325","197","195","2","534","413","398","15","859","53580","0.4047","39.9","1276","1983","1841","24","0","Worth County, Missouri","29","227"
"540","121","64","60","3936","1467","781","737","44","2469","1859","1653","206","3936","45594","0.4293","39.9","4998","9826","7924","30","124","Grundy County, Missouri","29","079"
"679","345","31","30","7588","3033","1828","1753","75","4555","3451","3176","275","7588","39003","0.4672","39.1","15598","19893","15644","44","45","Morgan County, Missouri","29","141"
"167","127","0","4","2596","990","649","632","17","1606","1266","1172","94","2596","40324","0.4368","39.1","4037","6130","5421","15","3","Reynolds County, Missouri","29","179"
"30295","23105","4956","11222","405984","124827","72623","69616","3007","281157","209200","189488","19712","405984","67420","0.4919","38.6","440960","984954","860710","37121","26883","St. Louis County, Missouri","29","189"
"1436","1353","21","4","12783","6249","4504","4235","269","6534","5204","4862","342","12783","49656","0.4624","39.0","21116","31240","27938","380","61","Stone County, Missouri","29","209"
"1929","583","40","27","13645","4856","3307","3149","158","8789","7016","6630","386","13645","44403","0.4814","40.2","17630","35209","28696","685","791","Barry County, Missouri","29","009"
"8950","6882","1788","869","70619","14863","8907","8555","352","55756","40333","31872","8461","70619","55328","0.4650","36.5","77314","176323","153507","3824","6705","Boone County, Missouri","29","019"
"4311","1334","145","169","30154","8732","4572","4401","171","21422","15988","14468","1520","30154","60066","0.4155","39.3","33335","72637","64622","1039","991","Cole County, Missouri","29","051"
"949","490","77","32","9578","3205","1902","1780","122","6373","4839","4412","427","9578","44438","0.4370","39.4","12078","23814","19709","88","94","Crawford County, Missouri","29","055"
"726","200","0","10","4074","1445","884","829","55","2629","2057","1881","176","4074","37435","0.4517","37.2","5321","9831","8611","97","10","Iron County, Missouri","29","093"
"955","336","24","29","5915","1952","1196","1155","41","3963","3042","2688","354","5915","46992","0.4284","38.9","6839","13840","12217","28","64","Livingston County, Missouri","29","117"
"1200","171","55","21","5436","1684","971","917","54","3752","3076","2916","160","5436","58010","0.4045","40.0","6191","14681","12380","83","37","Moniteau County, Missouri","29","135"
"325","571","0","32","6730","2052","1175","1120","55","4678","3526","3166","360","6730","33859","0.4900","39.6","8171","16499","14274","41","61","Pemiscot County, Missouri","29","155"
"1593","845","84","57","16033","4799","2782","2682","100","11234","8537","7884","653","16033","46157","0.4306","39.2","18279","41748","34122","925","866","Pettis County, Missouri","29","159"
"403","117","56","41","3064","1091","729","654","75","1973","1554","1440","114","3064","34265","0.4183","39.1","4182","8154","6612","10","3","Shannon County, Missouri","29","203"
"1368","261","121","37","8626","2728","1625","1557","68","5898","4395","4110","285","8626","47740","0.4139","38.5","10781","22855","20418","228","15","Randolph County, Missouri","29","175"
"1038","719","114","34","12342","3856","2009","1921","88","8486","6406","5762","644","12342","36380","0.5018","39.7","14428","29334","24343","165","244","Dunklin County, Missouri","29","069"
"3942","1125","34","87","40943","12075","7445","7202","243","28868","22995","20852","2143","40943","57214","0.4311","39.0","45136","102307","93093","732","322","Franklin County, Missouri","29","071"
"438","71","8","0","3471","1252","803","778","25","2219","1739","1605","134","3471","52700","0.4005","39.1","4591","9936","9098","44","23","Howard County, Missouri","29","089"
"13330","22566","2011","6822","286601","73362","42742","39966","2776","213239","146198","126927","19271","286601","55134","0.4627","39.2","323157","689210","584354","13776","13918","Jackson County, Missouri","29","095"
"1244","305","30","12","10111","3097","2012","1964","48","7014","5410","5071","339","10111","47171","0.4483","39.7","12946","24836","22161","63","55","Miller County, Missouri","29","131"
"28","185","0","0","1744","628","375","375","0","1116","758","686","72","1744","42849","0.4435","39.0","2992","4692","3925","20","11","Putnam County, Missouri","29","171"
"2206","2335","222","132","22272","8078","5186","4881","305","14194","11169","10355","814","22272","46031","0.4168","38.0","30833","54668","44930","771","310","Taney County, Missouri","29","213"
"4247","1248","249","250","33501","9633","5466","5220","246","23868","17415","15302","2113","33501","51916","0.4453","38.9","38750","85440","74140","1107","1409","Buchanan County, Missouri","29","021"
"506","162","23","2","3639","1256","766","745","21","2383","1789","1603","186","3639","49839","0.4022","40.5","4684","8856","7970","34","18","Caldwell County, Missouri","29","025"
"2956","435","15","168","5573","1116","543","530","13","4457","2721","1829","892","5573","36297","0.5438","32.1","6518","17612","15841","261","80","Radford city, Virginia","51","750"
"2303","1098","93","147","10490","3051","1713","1626","87","7439","5184","4391","793","10490","58818","0.4416","38.2","11919","27669","21893","985","971","Winchester city, Virginia","51","840"
"240","956","41","134","13438","5305","3377","3252","125","8133","6098","5670","428","13438","46073","0.4480","40.1","21273","32263","25820","443","636","Accomack County, Virginia","51","001"
"190","102","0","0","2297","693","449","410","39","1604","1049","1029","20","2297","55708","0.3833","38.2","2909","5094","4904","12","0","Craig County, Virginia","51","045"
"426","204","0","35","6493","2417","1367","1330","37","4076","3408","3151","257","6493","51521","0.4019","39.2","8048","15599","13939","160","64","Floyd County, Virginia","51","063"
"348","316","22","1","6910","2538","1533","1431","102","4372","3446","3032","414","6910","54520","0.3862","38.8","8357","16653","15113","80","11","Giles County, Virginia","51","071"
"601","281","31","53","6498","2659","1673","1607","66","3839","2746","2537","209","6498","36544","0.4515","38.7","9239","14708","12915","89","69","Grayson County, Virginia","51","077"
"1281","174","34","18","5446","2031","1125","1101","24","3415","2663","2571","92","5446","45535","0.5061","38.8","6775","13776","11627","226","133","Nottoway County, Virginia","51","135"
"179","111","21","16","2913","1327","927","891","36","1586","1166","1027","139","2913","74284","0.4633","38.6","3979","7373","6158","118","107","Rappahannock County, Virginia","51","157"
"288","57","27","66","2896","1173","766","717","49","1723","1238","1165","73","2896","57198","0.5152","38.7","3359","6992","6276","44","63","Charles City County, Virginia","51","036"
"2455","1261","151","188","17071","5351","3747","3608","139","11720","9881","9042","839","17071","77935","0.4055","39.6","18729","49800","42078","1632","1055","Culpeper County, Virginia","51","047"
"1503","289","67","108","10401","3445","2174","2023","151","6956","5314","5041","273","10401","60346","0.4326","38.0","11758","28164","24964","192","257","Dinwiddie County, Virginia","51","053"
"1157","335","41","110","7548","2163","1548","1465","83","5385","4193","3856","337","7548","67398","0.3836","38.2","8291","19322","16499","245","258","Greene County, Virginia","51","079"
"4913","1511","242","131","38987","12419","8267","8155","112","26568","22466","20973","1493","38987","89390","0.4024","38.8","41357","105093","96798","1955","1047","Hanover County, Virginia","51","085"
"312","32","25","48","4293","1774","1161","1154","7","2519","1961","1877","84","4293","44303","0.4000","39.6","5995","11311","9426","255","415","Lunenburg County, Virginia","51","111"
"2135","521","5","158","13679","4875","3262","3219","43","8804","6850","6264","586","13679","71548","0.3809","39.9","15142","35477","30928","574","630","Orange County, Virginia","51","137"
"508","140","7","16","2086","643","257","244","13","1443","1100","1089","11","2086","27063","0.4801","38.2","2385","5221","4407","53","34","Emporia city, Virginia","51","595"
"810","226","27","8","11983","4174","2590","2488","102","7809","6008","5465","543","11983","49364","0.4538","39.5","14375","28677","25989","107","58","Wythe County, Virginia","51","197"
"13739","7827","1605","657","84849","21401","14323","13778","545","63448","52379","49465","2914","84849","78640","0.4114","39.4","90802","227567","200346","7684","3026","Chesapeake city, Virginia","51","550"
"6951","3039","867","512","16723","3423","1683","1603","80","13300","10064","7404","2660","16723","46679","0.4839","34.3","18261","52590","39917","2232","3913","Harrisonburg city, Virginia","51","660"
"8401","3943","1391","1399","41496","13641","8132","7742","390","27855","21274","18227","3047","41496","79880","0.4794","37.2","45520","106023","89523","4696","4680","Albemarle County, Virginia","51","003"
"4125","1429","301","3","31317","10996","7563","7364","199","20321","16359","15234","1125","31317","64199","0.4408","39.1","36743","78005","70547","1154","794","Bedford County, Virginia","51","019"
"1068","106","23","44","5826","2195","1405","1339","66","3631","2793","2605","188","5826","49025","0.3970","39.7","7444","14974","13204","83","43","Buckingham County, Virginia","51","029"
"1232","988","84","90","14925","4658","2768","2685","83","10267","7886","7225","661","14925","38888","0.4731","39.4","17958","36190","31943","192","78","Wise County, Virginia","51","195"
"378","42","28","0","2384","848","483","457","26","1536","1085","1003","82","2384","40655","0.4479","37.7","2997","5498","4791","147","13","Covington city, Virginia","51","580"
"5498","2926","347","782","36370","10245","5935","5500","435","26125","17887","15708","2179","36370","52175","0.4324","39.4","40907","89616","78825","1071","730","Portsmouth city, Virginia","51","740"
"15254","18809","4215","2036","170798","44087","28381","27282","1099","126711","100644","89527","11117","170798","76610","0.4171","40.2","184794","424868","357234","23266","12054","Virginia Beach city, Virginia","51","810"
"287","185","0","35","6600","2532","1362","1347","15","4068","3146","2886","260","6600","47673","0.4595","38.9","8027","14861","13772","70","58","Alleghany County, Virginia","51","005"
"394","129","17","15","2663","965","476","476","0","1698","1253","1220","33","2663","33575","0.5191","37.6","3327","6273","5135","105","14","Galax city, Virginia","51","640"
"980","450","5","30","7923","3168","1904","1660","244","4755","3473","3097","376","7923","53853","0.4791","40.0","10951","17537","15166","126","182","Westmoreland County, Virginia","51","193"
"754","111","31","8","5584","3204","2094","1942","152","2380","1911","1769","142","5584","62632","0.4507","39.0","9277","12190","10895","59","102","Northumberland County, Virginia","51","133"
"1660","578","27","44","14533","5251","3441","3351","90","9282","6853","6138","715","14533","53866","0.4271","39.3","17304","33022","30165","367","170","Pulaski County, Virginia","51","155"
"2205","443","89","32","14651","4432","2948","2810","138","10219","7890","7215","675","14651","69116","0.3967","39.0","16387","39180","33822","760","478","Warren County, Virginia","51","187"
"1389","905","99","437","18293","6253","3373","3203","170","12040","8125","7199","926","18293","37203","0.4832","38.0","22072","39900","35182","535","332","Danville city, Virginia","51","590"
"4305","1134","309","852","10762","2336","1223","1133","90","8426","5547","4493","1054","10762","65641","0.4579","37.4","11725","28442","23709","720","898","Fredericksburg city, Virginia","51","630"
"2095","562","139","40","12160","4577","2824","2695","129","7583","6029","5606","423","12160","52888","0.4197","38.4","14190","31589","28205","288","146","Amherst County, Virginia","51","009"
"167","147","0","28","1801","631","365","333","32","1170","945","767","178","1801","49738","0.3879","39.3","3379","4231","3675","11","53","Bath County, Virginia","51","017"
"1750","944","8","38","9224","2647","1527","1373","154","6577","4911","4394","517","9224","39030","0.4642","39.2","10323","22156","19504","364","213","Hopewell city, Virginia","51","670"
"9392","8117","1289","3012","69835","16758","9932","9350","582","53077","36930","32853","4077","69835","53215","0.4438","39.3","77759","169839","141448","5799","3557","Newport News city, Virginia","51","700"
"4924","1465","452","87","31503","10099","6936","6763","173","21404","18105","16839","1266","31503","78002","0.3905","39.3","34161","85121","74493","1648","1745","Frederick County, Virginia","51","069"
"5076","4149","612","985","28273","7986","4537","4256","281","20287","14702","11945","2757","28273","46409","0.4623","35.1","32410","78994","68564","1203","2021","Lynchburg city, Virginia","51","680"
"4207","3150","1097","88","25103","7437","4884","4694","190","17666","15185","14228","957","25103","92069","0.3890","39.3","27896","64131","56773","3092","1507","York County, Virginia","51","199"
"1178","267","15","109","5532","1757","1091","1045","46","3775","2460","2230","230","5532","34371","0.5028","39.3","7067","12429","10636","192","215","Martinsville city, Virginia","51","690"
"553","115","30","0","6419","2682","1968","1911","57","3737","2891","2610","281","6419","64313","0.4654","39.0","10175","14785","13064","166","209","Nelson County, Virginia","51","125"
"997","996","24","38","26267","9807","6403","6249","154","16460","13026","12221","805","26267","47690","0.4442","39.0","31650","60021","54226","330","306","Pittsylvania County, Virginia","51","143"
"432","577","10","0","2517","888","605","594","11","1629","1267","1157","110","2517","32455","0.4944","36.3","2866","6394","5624","24","44","Buena Vista city, Virginia","51","530"
"1047","553","525","1369","5493","1245","721","685","36","4248","3192","2921","271","5493","127610","0.4556","39.3","6004","14060","11190","1611","884","Falls Church city, Virginia","51","610"
"3013","940","231","309","13165","3906","2135","1982","153","9259","5440","4662","778","13165","38679","0.4896","38.1","16367","30438","25846","419","411","Petersburg city, Virginia","51","730"
"786","322","94","0","4593","1537","1105","1095","10","3056","2535","2386","149","4593","97118","0.3912","38.9","4801","11782","10926","377","122","Poquoson city, Virginia","51","735"
"2220","495","548","996","8577","2214","1676","1607","69","6363","5144","4309","835","8577","116979","0.4053","38.6","8959","22994","15706","3340","2186","Fairfax city, Virginia","51","600"
"1929","269","170","108","9193","2886","1297","1199","98","6307","4393","3865","528","9193","45011","0.4641","38.7","10023","21960","18453","142","380","Waynesboro city, Virginia","51","820"
"5979","2406","437","1686","41740","11609","6483","6011","472","30131","19298","16484","2814","41740","44230","0.4802","38.5","47010","98035","82459","2028","2932","Roanoke city, Virginia","51","770"
"4895","2573","631","162","33774","9246","6146","5960","186","24528","20022","18772","1250","33774","74884","0.4341","39.7","36769","87819","79611","1744","906","Suffolk city, Virginia","51","800"
"17760","18419","1991","4622","88353","19880","11198","10560","638","68473","47103","39927","7176","88353","51590","0.4910","40.7","97670","215745","177936","7208","4932","Norfolk city, Virginia","51","710"
"628","21","8","69","4954","1783","1161","1086","75","3171","2551","2368","183","4954","57946","0.4392","38.6","5591","12861","11439","91","0","Amelia County, Virginia","51","007"
"14199","7931","1566","693","124971","35254","23516","22616","900","89717","73883","68566","5317","124971","82599","0.4076","39.0","130707","340982","293729","13864","7421","Chesterfield County, Virginia","51","041"
"31778","40564","18331","59130","396501","103131","72437","69327","3110","293370","234889","213988","20901","396501","124831","0.4258","39.2","413885","1131851","746265","184288","108200","Fairfax County, Virginia","51","059"
"1513","1039","176","128","17675","6520","4081","3889","192","11155","8776","7989","787","17675","47240","0.4317","37.3","23208","41341","34385","787","1465","Okanogan County, Washington","53","047"
"5748","1222","317","340","18347","5218","3065","2931","134","13129","9661","6998","2663","18347","56004","0.4535","35.8","23801","45547","40567","1072","1101","Kittitas County, Washington","53","037"
"3355","2413","66","53","39770","12052","7740","7454","286","27718","23202","21819","1383","39770","69433","0.3964","39.4","41833","102805","93507","1058","781","Cass County, Missouri","29","037"
"1012","508","59","96","8177","2313","1433","1306","127","5864","4786","4396","390","8177","62701","0.3673","39.5","9001","20044","18322","188","94","Clinton County, Missouri","29","049"
"684","40","0","15","6209","2300","1508","1431","77","3909","3058","2757","301","6209","43542","0.4724","40.4","7683","16382","13557","102","159","Dallas County, Missouri","29","059"
"580","120","12","0","3976","2116","1215","1147","68","1860","1273","1213","60","3976","34182","0.4235","41.0","6869","9326","7833","45","0","Hickory County, Missouri","29","085"
"2539","643","65","110","19286","5137","3258","3162","96","14149","11993","11292","701","19286","64196","0.4017","38.9","21681","55897","50906","441","182","Lincoln County, Missouri","29","113"
"224","76","0","0","3702","1308","784","754","30","2394","1824","1657","167","3702","43966","0.4071","39.4","4862","8522","7671","17","24","Monroe County, Missouri","29","137"
"2764","1427","67","58","22202","6922","4382","4175","207","15280","12249","11352","897","22202","50813","0.4716","39.5","24753","57544","49055","713","502","Newton County, Missouri","29","145"
"1274","287","48","10","6589","2149","1273","1208","65","4440","3342","2990","352","6589","46385","0.4326","39.7","7913","16245","14705","36","24","Pike County, Missouri","29","163"
"12766","6203","764","350","146631","40469","25880","25051","829","106162","86738","80081","6657","146631","84978","0.3962","38.6","154273","392268","361252","7164","6150","St. Charles County, Missouri","29","183"
"4568","1913","422","138","29594","8369","5061","4827","234","21225","16646","14052","2594","29594","53732","0.4609","37.9","33950","77243","69257","536","1320","Cape Girardeau County, Missouri","29","031"
"2152","1491","310","6","21646","6845","4119","3950","169","14801","11707","10827","880","21646","50351","0.4436","40.1","24070","54520","48645","389","478","Coffee County, Tennessee","47","031"
"1229","920","106","10","15596","5578","4035","3934","101","10018","8054","7633","421","15596","60711","0.4780","40.4","17114","39584","36369","245","177","Fayette County, Tennessee","47","047"
"247","25","0","26","2742","999","600","600","0","1743","1204","1129","75","2742","30136","0.5593","38.6","3621","6417","5688","39","0","Hancock County, Tennessee","47","067"
"2359","566","8","79","23135","8112","5136","4988","148","15023","11491","10929","562","23135","41924","0.4672","38.6","27290","55941","50393","233","314","Hawkins County, Tennessee","47","073"
"748","471","11","56","6794","2885","1868","1819","49","3909","3059","2816","243","6794","36004","0.5183","38.4","9002","15777","13787","41","162","Johnson County, Tennessee","47","091"
"957","940","61","48","13548","4564","2809","2703","106","8984","6983","6561","422","13548","49485","0.4415","39.5","15545","33573","30391","150","204","Lincoln County, Tennessee","47","103"
"861","373","14","0","9170","2642","1533","1513","20","6528","5145","4702","443","9170","37430","0.4589","40.2","10339","23460","20709","84","91","Macon County, Tennessee","47","111"
"404","86","9","0","2592","838","623","578","45","1754","1376","1284","92","2592","57708","0.4439","39.9","3050","6282","5575","16","93","Moore County, Tennessee","47","127"
"3493","1036","257","126","25713","7112","4950","4717","233","18601","16036","15323","713","25713","63307","0.4240","40.2","27315","69307","62016","585","748","Robertson County, Tennessee","47","147"
"1317","884","97","18","16326","5519","3716","3551","165","10807","8120","7646","474","16326","51585","0.4796","38.9","19351","41376","36946","335","514","Franklin County, Tennessee","47","051"
"2691","2294","257","68","50557","17688","11759","11285","474","32869","25578","23520","2058","50557","56667","0.4520","39.1","57709","128660","115055","1356","1062","Blount County, Tennessee","47","009"
"2281","501","204","42","15089","4183","2921","2787","134","10906","9039","8235","804","15089","61913","0.3830","39.6","16263","39814","35453","382","229","Cheatham County, Tennessee","47","021"
"2018","1274","59","19","23784","8347","5098","5023","75","15437","11275","10233","1042","23784","38092","0.4719","39.2","28173","55390","48181","263","256","Carter County, Tennessee","47","019"
"1058","592","50","42","8959","3190","2148","2044","104","5769","4683","4466","217","8959","44064","0.4515","38.7","11127","22958","20467","133","75","Grainger County, Tennessee","47","057"
"992","691","184","0","11904","4014","2510","2328","182","7890","6116","5479","637","11904","49614","0.4346","40.4","14095","28857","25623","159","392","Giles County, Tennessee","47","055"
"1548","247","42","34","9675","2973","1928","1855","73","6702","5210","4898","312","9675","39896","0.4300","40.0","11317","23153","20674","160","51","Lauderdale County, Tennessee","47","097"
"898","591","37","16","15960","5475","3136","3043","93","10485","8565","7985","580","15960","43614","0.4430","39.7","18260","42913","37147","160","121","Lawrence County, Tennessee","47","099"
"2951","1319","222","239","37944","11098","6752","6577","175","26846","20033","18542","1491","37944","48161","0.4717","38.8","43124","96293","85799","1230","375","Madison County, Tennessee","47","113"
"443","325","21","9","11477","3857","2596","2524","72","7620","5912","5590","322","11477","49432","0.4418","39.4","13370","28247","25766","78","107","Marion County, Tennessee","47","115"
"533","109","30","9","9140","3209","1905","1875","30","5931","4567","4345","222","9140","37197","0.4550","38.6","10366","21775","19643","196","69","Overton County, Tennessee","47","133"
"409","138","0","0","2281","999","627","606","21","1282","1003","994","9","2281","39554","0.4628","38.7","3508","4999","4785","14","0","Pickett County, Tennessee","47","137"
"529","314","22","0","5764","2184","1252","1204","48","3580","2937","2812","125","5764","41427","0.4529","39.3","7349","14612","12764","74","27","Wayne County, Tennessee","47","181"
"10460","10857","1272","362","77855","19146","14320","13767","553","58709","51331","48961","2370","77855","112962","0.4434","39.0","81772","224921","200182","7765","6745","Williamson County, Tennessee","47","187"
"1140","519","146","35","17029","5017","3387","3247","140","12012","10220","9457","763","17029","50415","0.4434","41.0","19133","47915","41081","603","840","Bedford County, Tennessee","47","003"
"1479","1635","177","9","27396","9740","6189","5989","200","17656","13225","12321","904","27396","42595","0.4777","39.0","32534","67539","60485","334","350","Greene County, Tennessee","47","059"
"1717","1910","63","0","25801","11910","8271","7866","405","13891","10600","9826","774","25801","45958","0.4276","39.5","29714","58597","52102","576","289","Cumberland County, Tennessee","47","035"
"370","52","12","9","2141","856","573","543","30","1285","1068","1002","66","2141","42724","0.4072","39.4","2692","5653","4744","31","41","Van Buren County, Tennessee","47","175"
"655","1319","118","26","13281","4333","2746","2627","119","8948","6503","6056","447","13281","36835","0.4798","40.3","15421","31098","28534","62","139","Claiborne County, Tennessee","47","025"
"563","142","14","14","8636","2962","1828","1758","70","5674","4159","3853","306","8636","43596","0.4718","39.9","10496","23094","20937","119","64","Hickman County, Tennessee","47","081"
"742","215","4","0","6763","2411","1448","1441","7","4352","3182","2934","248","6763","45667","0.4470","39.2","8955","18211","16741","36","32","Humphreys County, Tennessee","47","085"
"4480","1657","250","2","31424","9121","5560","5401","159","22303","16719","14274","2445","31424","44259","0.4779","38.5","34336","76513","67745","938","1465","Putnam County, Tennessee","47","141"
"2550","3413","535","196","37210","12527","8782","8356","426","24683","19812","17820","1992","37210","49610","0.4242","38.6","57424","96046","79195","1043","1151","Sevier County, Tennessee","47","155"
"736","492","12","14","5178","1898","1146","1085","61","3280","2350","2270","80","5178","45809","0.4030","40.6","6863","13223","11966","126","91","Stewart County, Tennessee","47","161"
"470","481","8","6","6060","2077","1339","1250","89","3983","3415","3221","194","6060","51946","0.4147","39.8","7125","16930","14413","88","128","Chester County, Tennessee","47","023"
"309","70","23","28","4440","1761","1119","1108","11","2679","2053","1951","102","4440","42031","0.4923","40.4","6910","11444","10340","42","22","Decatur County, Tennessee","47","039"
"433","202","52","5","4566","1868","987","910","77","2698","1968","1835","133","4566","35207","0.4660","37.7","5907","11469","10139","20","24","Jackson County, Tennessee","47","087"
"480","456","26","7","10022","3754","2284","2251","33","6268","4749","4473","276","10022","39161","0.4404","40.1","12060","25506","22602","98","55","McNairy County, Tennessee","47","109"
"2038","2088","99","5","20901","7985","4835","4709","126","12916","9973","9239","734","20901","53367","0.4799","38.6","25657","52392","47426","609","268","Roane County, Tennessee","47","145"
"2773","2702","243","92","40192","12204","8078","7714","364","27988","21511","19602","1909","40192","51331","0.4539","38.6","43736","104628","89343","1777","1892","Bradley County, Tennessee","47","011"
"2143","792","180","38","24456","8184","5027","4855","172","16272","12652","11536","1116","24456","43619","0.4540","38.9","27169","63301","54726","643","897","Hamblen County, Tennessee","47","063"
"908","339","22","7","7405","2407","1626","1586","40","4998","4104","3885","219","7405","44671","0.4700","39.2","9381","19304","17001","61","122","Union County, Tennessee","47","173"
"381","353","8","16","10137","3689","2336","2267","69","6448","5170","4936","234","10137","40682","0.4817","39.8","14079","25278","22331","53","11","Hardin County, Tennessee","47","071"
"2241","1066","54","22","19198","5667","3565","3286","279","13531","10632","9744","888","19198","53076","0.4424","39.5","21813","52292","45912","358","294","Dickson County, Tennessee","47","043"
"1530","259","23","2","7625","2688","1709","1658","51","4937","4221","4001","220","7625","41333","0.4534","38.5","9041","18692","16721","36","32","Morgan County, Tennessee","47","129"
"1339","1556","111","64","17987","6386","4298","4185","113","11601","9093","8662","431","17987","42429","0.4371","40.1","21235","45514","40488","583","245","Monroe County, Tennessee","47","123"
"669","904","11","18","13394","5297","3208","3043","165","8097","6526","5981","545","13394","40502","0.4678","38.5","17236","31794","28705","189","67","Henry County, Tennessee","47","079"
"648","89","6","0","5491","1788","1100","1050","50","3703","2897","2650","247","5491","44717","0.4459","39.9","6414","14184","12364","170","75","Crockett County, Tennessee","47","033"
"1077","96","0","0","2243","746","503","484","19","1497","1133","1014","119","2243","35191","0.5416","41.4","2607","4603","4048","25","9","Lake County, Tennessee","47","095"
"16326","14865","1814","1778","187319","51283","30757","29307","1450","136036","99865","86728","13137","187319","57470","0.4808","38.5","205620","457097","404708","8791","7821","Knox County, Tennessee","47","093"
"6429","4912","619","661","72121","20040","12478","11773","705","52081","41407","37621","3786","72121","69023","0.4246","38.5","76241","196146","166469","7518","7911","Benton County, Washington","53","005"
"6666","21549","2273","4621","174661","49829","32452","30776","1676","124832","102458","91149","11309","174661","75253","0.4237","38.4","182742","470426","402647","26490","14075","Clark County, Washington","53","011"
